啊	aadz
阿	aatz
吖	aadg
锕	aazz
腌	aava
爱	aiyr
哎	aidb
唉	aido
艾	ailb
挨	aiuo
癌	aiav
矮	aiob
哀	aitd
埃	aigo
碍	aimk
欸	aike
砹	aimb
隘	aita
瑷	ainr
暧	aior
毐	aigk
嗳	aidr
蔼	ailf
锿	aizd
霭	aitf
嗌	aida
叆	aibr
嫒	aibr
皑	aiuv
按	anub
安	anwb
案	anwe
俺	anja
暗	anox
氨	anvb
胺	anvb
庵	anxa
岸	anve
鞍	antb
黯	anpx
铵	anzb
桉	aneb
唵	anda
谙	ansx
埯	anga
盦	anja
垵	angb
犴	anme
鹌	anmx
𩽾	anwb
昂	ahoz
卬	ahbz
盎	ahma
肮	ahvo
奥	aotm
熬	aoac
嗷	aodh
澳	aokm
凹	aomf
傲	aojh
敖	aoah
鳌	aoaw
袄	aotm
螯	aoac
拗	aous
坳	aogs
獒	aoam
媪	aoba
岙	aotv
翱	aouz
遨	aoau
鏊	aoaz
薁	aolm
懊	aohm
璈	aonh
鏖	aoxz
骜	aoan
隩	aotm
聱	aoaq
奡	aofp
廒	aoxh
嶅	aoav
吧	badm
把	baum
八	bahb
巴	bamb
扒	bauh
拔	baui
罢	bayk
叭	badh
爸	bahm
靶	batm
钯	bazm
疤	baam
霸	batv
芭	balm
耙	baam
坝	bago
灞	bakv
捌	baup
跋	bapi
粑	bapm
魃	baai
鲃	bawm
妭	babi
鲅	bawi
菝	bali
羓	bagm
胈	bavi
朳	baeh
笆	barm
岜	bavm
蚆	bacm
白	bdub
摆	bduk
拜	bdua
百	bdfu
掰	bduu
败	bdoh
柏	bdeu
佰	bdju
稗	bdxn
捭	bdun
伯	bdju
版	bjar
班	bjnn
半	bjhu
板	bjer
般	bjir
办	bjsh
搬	bjur
拌	bjuu
斑	bjnn
伴	bjju
瓣	bjnn
扮	bjup
扳	bjur
绊	bjiu
颁	bjhw
坂	bjgr
阪	bjtr
钣	bjzr
癍	bjan
柈	bjeu
攽	bjhh
瘢	bjar
昄	bjor
湴	bjkc
靽	bjtu
𨭉	bjvz
帮	bhar
棒	bheu
榜	bhel
磅	bhml
邦	bhat
绑	bhit
镑	bhzl
傍	bhjl
蚌	bhca
浜	bhkh
谤	bhsl
梆	bhet
膀	bhvl
搒	bhul
玤	bhna
蒡	bhll
塝	bhgl
𠳐	bhdt
包	bcnv
宝	bcwi
报	bcur
保	bcje
爆	bcck
抱	bcuv
薄	bclk
堡	bcjg
曝	bcok
饱	bcqv
鲍	bcwv
煲	bcjc
剥	bcbp
暴	bcok
豹	bcmi
刨	bcnp
褒	bcte
胞	bcvv
葆	bcle
苞	bclv
鸨	bcvx
炮	bccv
雹	bctv
孢	bchv
枹	bcev
龅	bclv
趵	bcpi
褓	bcte
瀑	bckk
被	bwtr
背	bwav
倍	bwjd
呗	bwdo
杯	bwec
北	bwav
贝	bwob
备	bwhq
悲	bwrh
碑	bwmn
辈	bwry
钡	bwzo
焙	bwcd
邶	bwat
卑	bwun
悖	bwhh
孛	bwnh
蓓	bwld
陂	bwtr
碚	bwmd
琲	bwnr
惫	bwhh
鹎	bwux
鞴	bwtt
狈	bwmo
棓	bwed
椑	bwen
褙	bwtv
糒	bwpt
臂	bwcv
鐾	bwcz
鞁	bwtr
𬇙	bwko
本	bfef
笨	bfrf
奔	bfml
苯	bflf
畚	bfkq
贲	bfno
锛	bfzl
犇	bfqq
坌	bfhg
夯	bfms
倴	bfjl
栟	bfel
崩	bgvv
蹦	bgpv
泵	bgmk
甭	bgct
绷	bgiv
嘣	bgdv
迸	bghu
甏	bghr
蚌	bgca
琫	bgnu
祊	bgfl
镚	bgzv
比	bivv
笔	birv
逼	bifu
必	biht
币	bitr
鼻	biol
臂	bicv
壁	bicg
彼	biwr
毕	bivn
避	bicu
碧	binm
哔	bidn
闭	biat
弊	bifl
璧	bici
铋	bizt
敝	bifh
匕	bivb
毙	bivv
俾	bijn
鄙	bidt
蔽	bilh
婢	bibn
濞	bikl
庇	bixv
畀	biql
陛	bitg
弼	bibb
痹	bial
妣	bibv
髀	bifn
吡	bidv
屄	bice
箅	birl
滗	bikv
庳	bixn
嬖	bicb
芘	bilv
沘	bikv
毖	bivt
蓖	bilv
裨	bitn
苾	bilt
愎	bihh
篦	birv
邲	biht
皕	bifu
襞	bict
萆	biln
荜	biln
薜	biln
跸	bipn
咇	bidt
珌	bint
舭	biiv
辟	bicn
佖	bijt
赑	bioo
荸	bilh
诐	bisr
筚	birn
秕	bixv
贲	bino
狴	bimg
佛	bijt
觱	bint
馝	bixt
泌	bikt
秘	bixt
鲾	biwq
坒	bivg
便	bmjb
边	bmsu
变	bmzr
遍	bmmu
编	bmii
贬	bmor
辩	bmnn
扁	bmmi
鞭	bmtb
辨	bmnn
蝙	bmci
卞	bmzy
煸	bmci
弁	bmkl
辫	bmnn
匾	bmni
汴	bmky
抃	bmuy
昪	bmol
苄	bmly
笾	bmru
砭	bmmr
鳊	bmwi
萹	bmli
忭	bmhy
碥	bmmi
褊	bmti
𨚕	bmkt
𰻝	bleu
表	bnat
标	bnef
婊	bnbt
飙	bnmb
镖	bnzf
彪	bnze
裱	bntt
膘	bnvf
杓	bnei
鳔	bnwf
镳	bnzc
骉	bnnn
熛	bncf
摽	bnuf
幖	bnrf
骠	bnnf
藨	bnlc
儦	bnjc
瀌	bnkc
俵	bnjt
飑	bnov
瘭	bnaf
脿	bnvt
别	bpdp
憋	bpfh
鳖	bpfw
瘪	bpaj
蹩	bpfp
癿	bpua
宾	bbwh
斌	bbvs
彬	bbee
髌	bbfh
鬓	bbph
滨	bbkh
豳	bbvj
邠	bbht
缤	bbih
膑	bbvh
殡	bbgh
濒	bbkw
摈	bbuh
玢	bbnp
傧	bbjh
镔	bbzh
槟	bbeh
并	bkhl
病	bkaj
兵	bkth
冰	bkwk
饼	bkql
柄	bkej
丙	bkfj
禀	bkzf
屏	bkcl
秉	bkxb
炳	bkcj
蛃	bkcj
昺	bkoj
摒	bkul
槟	bkeh
邴	bkft
栟	bkel
波	bokr
博	bonk
播	bouq
薄	bolk
拨	boui
伯	boju
铂	bozu
搏	bouk
啵	bodr
钵	bozf
勃	bons
驳	bonb
玻	bonr
脖	bovh
帛	bour
剥	bobp
跛	bopr
亳	bogr
箔	boru
柏	boeu
孛	bonh
泊	boku
钹	bozi
渤	boks
镈	bozk
僰	boej
菠	bolr
擘	bocu
浡	bokh
舶	boiu
嶓	bovq
膊	bovk
哱	bodh
砵	bomf
卜	boyb
踣	bopd
簸	borr
鹁	bonx
檗	boce
鲌	bowu
蕃	bolq
艴	botm
趵	bopi
馞	boxh
袯	boti
饽	boqh
礴	bomk
欂	boek
𬭛	bozr
不	bucb
部	buit
补	buty
步	buss
布	bunr
簿	burk
钚	buzc
捕	buun
卜	buyb
怖	buhr
卟	budy
晡	buon
埠	bugn
逋	bunu
堡	bujg
哺	budn
蔀	bult
瓿	buir
醭	buyi
埔	bugn
埗	bugs
𬷕	bunx
擦	cauf
嚓	cadf
才	cdnt
菜	cdle
踩	cdpe
猜	cdmv
蔡	cdlf
财	cdot
采	cdye
材	cdet
裁	cdnt
彩	cdye
睬	cdqe
偲	cdjh
惨	cjhe
餐	cjgq
残	cjgp
参	cjke
蚕	cjfc
粲	cjgp
灿	cjcv
骖	cjne
惭	cjht
璨	cjnp
黪	cjpe
䅟	cjxe
藏	chlq
仓	chjz
舱	chiz
苍	chlz
沧	chkz
鸧	chjx
伧	chjz
草	ccln
槽	cceo
曹	ccfo
操	ccue
艹	cclc
糙	ccpu
屮	ccsc
嘈	ccdo
漕	ccko
芔	ccsl
肏	ccjj
艚	ccio
螬	ccco
𥕢	ccmo
侧	cejp
测	cekp
册	ceic
策	cerm
厕	cexp
恻	cehp
𤭢	cwzr
岑	cfva
涔	cfka
参	cfke
曾	cgho
层	cgcb
蹭	cgpo
噌	cgdo
嶒	cgvo
差	iagu
茶	iale
查	iaef
插	iaup
叉	iari
侘	iajr
茬	ialg
镲	iazf
察	iawf
猹	iamf
搽	iaue
槎	iaeu
岔	iahv
檫	iaef
杈	iaei
嚓	iadf
碴	iamf
姹	iabr
汊	iaki
衩	iati
锸	iazp
垞	iagr
诧	iasr
馇	iaqf
刹	iabp
喳	iadf
蹅	iapf
嵖	iavf
𥻗	iapf
拆	idui
柴	idse
差	idgu
钗	idzi
豺	idmt
虿	idfc
侪	idjq
瘥	idau
茝	idlq
产	ijix
铲	ijzx
馋	ijqw
缠	ijid
禅	ijfn
蝉	ijcn
掺	ijue
颤	ijzw
搀	ijuw
谗	ijsw
浐	ijkx
婵	ijbn
蟾	ijcs
澶	ijkf
觇	ijye
阐	ijan
躔	ijpg
襜	ijts
谄	ijsp
镡	ijzn
刬	ijfp
辿	ijvu
忏	ijhl
巉	ijvw
韂	ijts
羼	ijcg
廛	ijxg
潺	ijkh
梴	ijeu
孱	ijch
蒇	ijlo
啴	ijdn
单	ijhn
骣	ijnh
镵	ijzw
瀍	ijkg
旵	ijov
冁	ijht
儳	ijjw
𬊤	ijcn
唱	ihdo
场	ihge
长	ihpc
常	ihsr
厂	ihxc
尝	ihsb
肠	ihve
畅	ihoe
昌	ihoo
偿	ihjb
敞	ihsh
娼	ihbo
鬯	ihpv
怅	ihhp
倡	ihjo
昶	ihio
猖	ihmo
嫦	ihbr
氅	ihsv
伥	ihjp
苌	ihlp
鲳	ihwo
菖	ihlo
徜	ihws
裳	ihst
阊	ihao
鲿	ihwb
惝	ihhs
𬬮	ihzp
超	icpd
抄	icut
炒	icct
朝	icnv
潮	ickv
吵	icdt
钞	iczt
巢	icoe
嘲	icdv
焯	iccn
晁	icow
怊	ichd
绰	icin
弨	icbd
耖	icat
车	ieyc
扯	ieus
撤	ieuh
彻	iewp
掣	iequ
澈	iekh
坼	iegi
尺	ieci
砗	iemy
㬚	ieoh
陈	ifty
趁	ifpe
臣	ifqc
沉	ifko
辰	iffc
尘	ifyg
琛	ifne
抻	ifug
嗔	ifdh
衬	iftk
晨	ifof
称	ifxy
宸	ifwf
谶	ifsf
谌	ifsa
瞋	ifqh
忱	ifhp
梣	ifea
煁	ifca
榇	ifee
龀	iflv
疢	ifac
棽	ifea
碜	ifme
郴	ifet
𬘭	ifie
成	igna
称	igxy
城	igga
呈	igdn
乘	igxv
撑	iguu
橙	igez
程	igxn
秤	igxh
盛	igna
承	igat
诚	igsa
丞	igaf
澄	igkz
逞	igdu
惩	igwh
枨	igep
埕	iggn
骋	igna
铖	igza
澂	igkh
珵	ignn
琤	ignb
塍	igvg
偁	igjg
蛏	igcg
赪	iggo
噌	igdo
酲	igyn
宬	igwa
柽	igeg
瞠	igqg
珹	igna
牚	igsl
晟	igoa
铛	igzb
憕	ighz
裎	igtn
庱	igxh
吃	iida
池	iike
持	iiuk
赤	iigc
尺	iici
迟	iicu
齿	iilc
敕	iixh
痴	iiad
驰	iine
翅	iicz
耻	iiqs
嗤	iidc
豉	iizc
斥	iiti
螭	iicv
叱	iidv
彳	iiwc
蚩	iisc
炽	iich
笞	iird
哧	iidc
媸	iibc
饬	iiqs
侈	iijl
弛	iibe
褫	iitz
魑	iiav
摛	iiuv
鸱	iibx
啻	iiid
瘛	iiah
漦	iiak
墀	iigq
茌	iilg
匙	iiov
眵	iiql
篪	iirz
傺	iijf
踟	iipd
胣	iive
瓻	iibr
痓	iiay
𫄨	iiir
冲	iswg
重	isld
充	isbp
虫	iscc
宠	iswt
崇	isvf
铳	iszp
舂	isap
憧	ishd
摏	isup
艟	isid
翀	iszg
忡	ishg
茺	islp
涌	iskt
种	isxg
珫	isnp
漴	iskf
㳘	iskp
抽	izud
丑	izag
臭	izom
愁	izxh
瞅	izqc
仇	izjk
筹	izrk
稠	izxd
酬	izyo
雠	izuu
俦	izjk
绸	izid
畴	izqk
瘳	izae
惆	izhd
杻	izeg
帱	izrk
椆	ized
犨	izuq
踌	izpk
侴	izjp
出	iusm
处	iuhy
除	iutx
初	iutp
楚	iuet
厨	iuxk
触	iuxc
褚	iuto
杵	iuen
储	iujo
锄	iuzs
怵	iuhi
雏	iuxu
橱	iuek
畜	iuzq
黜	iupm
刍	iuxb
础	iumm
俶	iujr
楮	iueo
矗	iunf
亍	iuwc
滁	iukx
绌	iuim
樗	iuea
憷	iuht
斶	iutc
搐	iuuq
摴	iuua
躇	iupo
蜍	iucx
濋	iukt
蹰	iupk
䝙	iumb
䢺	iust
琡	iunr
𬺓	iult
欻	ixce
踹	ikpl
揣	ikul
搋	ikuz
啜	ikdr
穿	irel
传	irji
船	irid
川	iroc
串	irdg
氚	irvo
喘	irdl
钏	irzo
舛	irlv
椽	irej
遄	irvu
床	ilxe
创	iljp
窗	ileh
闯	ilan
疮	ilaz
怆	ilhz
幢	ilrd
噇	ildd
吹	ivde
锤	ivzg
捶	ivug
垂	ivlg
炊	ivce
槌	iveu
圌	ivrl
棰	iveg
倕	ivjg
陲	ivtg
纯	iyis
蠢	iyac
春	iyao
唇	iyfd
醇	iyyh
椿	iyeo
淳	iykh
蝽	iyco
鹑	iygx
莼	iyls
瑃	iyno
䲠	iywo
堾	iygo
𬭚	iyzh
戳	iozp
啜	iodr
辍	ioyr
绰	ioin
龊	iolp
踔	iopn
逴	ioyu
惙	iohr
次	ciwe
此	cisv
词	cisd
刺	ciep
赐	cioe
磁	cimi
茨	cile
呲	cidv
辞	cian
雌	cisu
瓷	ciwr
祠	cifd
慈	cihh
泚	cikv
疵	ciav
伺	cijd
玼	cinv
糍	cipi
跐	cipv
差	cigu
茈	cilv
兹	cihi
佽	cije
鹚	cihx
莿	cilp
𫚖	cisw
从	csjj
葱	cslh
聪	csqh
丛	csjf
琮	csnf
悰	cshf
骢	csnh
枞	csej
璁	csnh
淙	cskf
熜	csch
匆	csni
囱	csth
苁	cslj
凑	czwm
腠	czvm
辏	czym
粗	cupf
醋	cuyo
促	cujp
簇	curo
蹙	cunp
蹴	cupo
猝	cumn
殂	cugf
徂	cuwf
卒	cuzn
蔟	culo
窜	creg
蹿	crpg
汆	crjk
篡	crrk
爨	crpc
攒	cruo
撺	crug
镩	crzg
催	cvju
崔	cvvu
脆	cvvz
翠	cvzn
啐	cvdn
萃	cvln
摧	cvuu
淬	cvkn
粹	cvpn
毳	cvvv
璀	cvnu
悴	cvhn
瘁	cvan
漼	cvku
缞	cvif
榱	cvef
寸	cykc
存	cynh
村	cyek
邨	cyft
皴	cykr
忖	cyhk
错	cozo
搓	couu
挫	coug
措	couo
锉	cozg
厝	coxo
撮	cour
蹉	copu
矬	coog
痤	coag
瑳	conu
嵯	covu
鹾	coyu
磋	comu
脞	covg
棤	coeo
莝	colg
大	damd
打	daua
答	dard
达	damu
搭	daud
哒	dadu
嗒	dadd
妲	dabf
鞑	datu
怛	dahf
沓	dako
炟	dacf
跶	dapu
笪	darf
耷	damq
靼	datf
垯	dagu
溚	dakd
瘩	daad
褡	datd
荙	dalu
鿎	damu
𨱏	dazd
𫟼	dazu
带	ddlr
代	ddjp
待	ddwk
呆	ddde
戴	ddnh
贷	ddjo
袋	ddjt
黛	ddjp
逮	ddbu
岱	ddjv
殆	ddgd
迨	ddku
呔	dddi
歹	ddgd
玳	ddnp
傣	ddjk
怠	ddkh
绐	ddid
埭	ddgk
大	ddmd
轪	ddym
骀	ddnd
叇	ddbu
垈	ddjg
但	djjf
单	djhn
蛋	djtc
弹	djbn
淡	djkc
丹	djmz
氮	djvc
胆	djvf
担	djuf
旦	djof
啖	djdc
掸	djun
澹	djks
亶	djzf
石	djms
诞	djsu
惮	djhn
耽	djqp
儋	djjs
聃	djqg
殚	djgn
疍	djtf
箪	djrn
憺	djhs
膻	djvf
瘅	djan
眈	djqp
萏	djlp
赕	djoc
郸	djht
疸	djaf
𫢸	djjn
𬘘	djip
当	dhyb
党	dhsp
档	dheb
挡	dhub
裆	dhtb
荡	dhle
铛	dhzb
宕	dhwm
砀	dhme
凼	dhkm
珰	dhnb
谠	dhsp
菪	dhlm
垱	dhgb
筜	dhrb
𣗋	dhep
𬍡	dhki
到	dcyp
道	dchu
刀	dcpd
倒	dcjp
岛	dcxv
导	dcvk
盗	dcwa
叨	dcdp
氘	dcvp
稻	dcxp
捣	dcuv
悼	dchn
纛	dcai
蹈	dcpp
祷	dcfk
捯	dcup
忉	dchp
帱	dcrk
舠	dcip
鱽	dcwp
的	deui
得	dewk
地	dege
德	dewh
锝	dezk
嘚	dedk
得	dwwk
嘚	dwdk
扽	dfus
等	dgrk
灯	dgca
登	dghz
邓	dgrt
蹬	dgpz
凳	dgho
瞪	dgqz
噔	dgdz
镫	dgzz
戥	dgop
磴	dgmz
嶝	dgvz
澄	dgkz
璒	dgnz
地	dige
第	dirt
低	diji
滴	dikc
底	dixi
帝	diir
迪	didu
敌	diah
蒂	dilr
抵	diui
笛	dird
递	dihu
狄	dimc
弟	diht
镝	dizc
氐	dibi
嫡	dibc
堤	digt
骶	difi
棣	diek
邸	dibt
的	diui
碲	dimr
嘀	didc
睇	diqt
禘	difr
谛	disr
籴	dijp
砥	dimi
鞮	ditt
涤	dike
荻	dilc
菂	dili
娣	dibt
诋	disi
觌	dine
羝	digi
柢	diei
翟	dizu
杕	diem
髢	dipe
坻	digi
茋	dili
缔	diir
踶	dipt
媂	dibr
提	diut
蹢	dipc
玓	dini
䃅	dimn
䗖	dicr
𤧛	dinr
𬱖	didw
嗲	dxdl
点	dmyc
店	dmxd
电	dmoa
垫	dmug
碘	dmmh
殿	dmcr
颠	dmnw
典	dmih
滇	dmkh
甸	dmnq
掂	dmud
簟	dmrn
癫	dmaw
巅	dmvw
奠	dmhm
靛	dmat
钿	dmzq
踮	dmpd
佃	dmjq
淀	dmkt
玷	dmnd
惦	dmhd
坫	dmgd
癜	dmar
扂	dmmd
阽	dmtd
琔	dmnt
掉	dnun
调	dnsd
吊	dndr
屌	dncr
叼	dndf
钓	dnzi
雕	dnmu
刁	dnaf
貂	dnmd
凋	dnwd
鲷	dnwd
碉	dnmd
铫	dnzw
窎	dnex
铞	dnzr
汈	dnkf
跌	dpph
爹	dphl
叠	dprf
碟	dpme
蝶	dpce
迭	dptu
谍	dpse
牒	dpae
昳	dpoh
鲽	dpwe
喋	dpde
堞	dpge
瓞	dpyh
耋	dpqy
垤	dpgy
绖	dpiy
楪	dpee
蹀	dppe
𫶇	dpvr
定	dkwt
顶	dkaw
丁	dkad
盯	dkqa
订	dksa
钉	dkza
鼎	dkqa
叮	dkda
碇	dkmt
町	dkqa
腚	dkvt
锭	dkzt
玎	dkna
啶	dkdt
酊	dkya
仃	dkja
疔	dkaa
耵	dkqa
萣	dklt
丢	dqtk
铥	dqzk
懂	dshd
动	dsbs
东	dsry
洞	dskd
冻	dswy
冬	dshw
董	dsld
栋	dsey
咚	dsdw
氡	dsvw
侗	dsjd
鸫	dsrx
胴	dsvd
峒	dsvd
恫	dshd
硐	dsmd
岽	dsvy
垌	dsgd
胨	dsvy
𬟽	dscy
都	dzqt
斗	dzjd
抖	dzuj
豆	dzzd
逗	dzzu
兜	dzup
痘	dzaz
陡	dztp
窦	dzem
读	dzsm
蔸	dzlp
蚪	dzcj
钭	dzzj
篼	dzrp
读	dusm
度	duxr
都	duqt
赌	duoo
毒	duak
堵	dugo
杜	dueg
独	dumc
渡	dukr
督	duyq
肚	duvg
镀	duzr
笃	durn
嘟	dudt
蠹	dunc
睹	duqo
妒	dubm
犊	duqm
渎	dukm
椟	duem
牍	duam
阇	duao
厾	duak
芏	dulg
黩	dupm
髑	dufc
𬭊	duzg
端	dril
段	drur
短	droz
断	drpt
椴	drer
锻	drzr
缎	drir
耑	drvl
煅	drcr
塅	drgr
簖	drrt
瑖	drnr
对	dvrk
队	dvtj
怼	dvrh
堆	dvgu
兑	dvhp
碓	dvmu
祋	dvfr
㨃	dvuh
吨	dyds
蹲	dypk
盾	dyxq
炖	dycs
顿	dyfw
惇	dyhh
墩	dygh
遁	dyxu
钝	dyzs
敦	dygh
趸	dyfp
囤	dyrs
盹	dyqs
沌	dyks
镦	dyzh
礅	dymh
蹾	dyph
砘	dyms
多	doll
躲	doze
夺	domk
剁	doop
朵	dooe
堕	dotg
度	doxr
舵	doiv
跺	dope
铎	dozu
哆	dodl
踱	dopr
惰	dohv
垛	doge
咄	dodm
掇	dour
埵	dogg
亸	dogn
驮	donm
哚	dode
剟	dorp
裰	dotr
饳	doqm
㙍	dogr
额	eeww
恶	eefh
呃	eedz
俄	eejp
饿	eeqp
鹅	eetx
厄	eexz
讹	eesv
鳄	eewa
鄂	eedt
娥	eebp
欸	eeke
蛾	eecp
颚	eedw
腭	eeva
锇	eezp
扼	eeuz
阿	eetz
轭	eeyz
莪	eelp
遏	eeou
谔	eesa
屙	eecz
萼	eela
锷	eeza
鹗	eedx
愕	eeha
峨	eevp
涐	eekp
垩	eefg
崿	eeva
噩	eend
哦	eedp
婀	eebz
姶	eebd
苊	eelz
堨	eegf
𥔲	eema
𫫇	eedh
诶	eiso
欸	eike
嗯	endh
恩	enrh
摁	enuh
蒽	enlh
嗯	egdh
而	erle
二	erme
儿	erpe
耳	erqe
尔	erxy
贰	erpo
饵	erqq
迩	erxu
铒	erzq
珥	ernq
鸸	erlx
洱	erkq
鲕	erwl
耏	erle
陑	ertl
咡	erdq
发	fasi
法	fakk
伐	fajp
罚	fayp
阀	faap
乏	fatr
筏	farp
珐	fank
垡	fajg
砝	famk
反	fjxr
饭	fjqr
翻	fjtz
犯	fjmz
范	fjlz
泛	fjkr
凡	fjoi
番	fjtq
烦	fjcw
返	fjxu
帆	fjri
藩	fjlq
繁	fjei
梵	fjei
樊	fjem
蕃	fjlq
贩	fjor
钒	fjzi
矾	fjmi
幡	fjrq
燔	fjcq
氾	fjkz
蘩	fjli
璠	fjnq
蹯	fjpq
畈	fjqr
墦	fjgq
𫔍	fjzq
𬸪	fjtx
放	fhlh
方	fhlf
防	fhtl
房	fhml
仿	fhjl
坊	fhgl
芳	fhll
访	fhsl
钫	fhzl
昉	fhol
纺	fhil
枋	fhel
鲂	fhwl
妨	fhbl
肪	fhvl
舫	fhil
蚄	fhcl
邡	fhlt
牥	fhql
非	fwrf
费	fwto
飞	fwcf
肺	fwvr
废	fwxi
肥	fwvm
菲	fwlr
妃	fwbv
匪	fwnr
绯	fwir
斐	fwrv
吠	fwdm
沸	fwkt
啡	fwdr
霏	fwtr
榧	fwer
扉	fwmr
腓	fwvr
淝	fwkm
蜚	fwrc
朏	fwvm
镄	fwzo
诽	fwsr
痱	fwar
翡	fwrz
狒	fwmt
鲱	fwwr
悱	fwhr
芾	fwlr
棐	fwre
剕	fwrp
篚	fwrr
𬴂	fwnr
分	ffhp
粉	ffpp
份	ffjp
坟	ffgv
芬	fflp
粪	ffph
焚	ffec
汾	ffkp
酚	ffyp
忿	ffhh
愤	ffho
奋	ffmq
偾	ffjo
纷	ffip
氛	ffvp
棻	ffle
棼	ffep
鲼	ffwo
瀵	ffkh
玢	ffnp
翂	ffzp
吩	ffdp
坋	ffgp
鼢	ffpp
豮	ffjo
𣸣	ffko
风	fgob
封	fggk
冯	fgwn
峰	fgva
疯	fgab
缝	fgiu
奉	fgau
逢	fghu
锋	fgza
丰	fgaf
凤	fgor
枫	fgeb
蜂	fgca
俸	fgju
沣	fgka
讽	fgsb
葑	fglk
沨	fgkb
烽	fgca
酆	fgvt
唪	fgdu
砜	fgmb
崶	fgvk
赗	fgoq
浲	fgka
佛	fojt
否	fzcd
缶	fzaf
负	fuxo
附	futk
服	fuvr
副	fufp
付	fujk
福	fufq
府	fuxk
复	fueh
富	fuwq
夫	fuhf
赴	fupy
父	fuhb
扶	fuuh
氟	fuvt
赋	fuos
弗	futf
符	furk
伏	fujm
傅	fujk
幅	furq
敷	funh
芙	fulh
斧	fuht
釜	fuhz
腹	fuvh
浮	fukh
辅	fuyn
妇	fubb
甫	funf
覆	fuvh
抚	fuud
拂	fuut
腐	fuxj
缚	fuik
俘	fujh
俯	fujk
腑	fuvk
辐	fuyq
孚	fuyh
孵	fubh
佛	fujt
阜	futn
凫	fuxo
肤	fuvh
蝠	fucq
祓	fufi
脯	fuvn
芣	fulc
黼	fucn
鄜	fuxt
馥	fuxh
涪	fukd
桴	fueh
黻	fuci
苻	fulk
拊	fuuk
麸	fuah
郛	fuyt
玞	funh
簠	fura
绂	fuii
宓	fuwt
跗	fupk
茯	fulm
赙	fuok
莩	fulh
趺	fuph
茀	fult
蝮	fuch
稃	fuxh
匐	funq
罘	fuyc
驸	funk
怫	fuht
呋	fudh
袱	futm
洑	fukm
榑	fuek
鲋	fuwk
菔	fulr
滏	fukz
芾	fulr
咐	fudk
幞	furi
艴	futm
绋	fuit
蚨	fuch
韨	fugi
琈	funh
垺	fugh
讣	fusy
蜉	fuch
砆	fumh
㕮	fudb
㳇	fukb
𫓧	fuzh
𫖯	fupw
尬	gaop
嘎	gadp
噶	gadf
伽	gajd
尕	gavy
钆	gaza
咖	gadd
旮	gako
尜	gayy
轧	gaya
戛	gafp
该	gdsk
改	gdvh
盖	gdga
钙	gdza
概	gded
丐	gdfa
垓	gdgk
陔	gdtk
溉	gdkd
赅	gdok
荄	gdlk
戤	gdvp
晐	gdok
𬮿	gdtv
感	gjnh
干	gjeg
敢	gjah
肝	gjve
杆	gjee
赶	gjpe
甘	gjzg
柑	gjez
淦	gjkz
赣	gjxo
苷	gjlz
擀	gjue
绀	gjiz
竿	gjre
尴	gjoa
橄	gjeh
秆	gjxe
酐	gjye
鳡	gjwh
玕	gjne
矸	gjme
泔	gjkz
坩	gjgz
旰	gjoe
疳	gjaz
澉	gjkh
虷	gjce
㽏	gjkz
刚	ghmp
岗	ghvb
港	ghkv
杠	gheu
缸	ghau
钢	ghzb
纲	ghib
肛	ghvu
冈	ghmb
罡	ghys
矼	ghmu
扛	ghuu
戆	ghxh
冮	ghwu
堽	ghgs
筻	ghrb
㭎	gheb
鿍	ghgv
高	gcgg
搞	gcug
稿	gcxg
告	gcqd
膏	gcgv
糕	gcpc
镐	gczg
诰	gcsd
皋	gcun
锆	gczd
郜	gcqt
缟	gcig
睾	gctg
藁	gcle
杲	gcoe
篙	gcrg
槔	gcen
羔	gcgc
槁	gceg
筶	gcrd
个	gejg
各	gesg
哥	gezz
歌	geze
格	gees
割	gewp
隔	getn
咯	geds
搁	geus
戈	gepg
葛	gelf
阁	geas
铬	gezs
鸽	gejx
镉	gezn
革	getg
嗝	gedn
硌	gems
膈	gevn
鬲	geng
胳	gevs
蛤	gecd
骼	gefs
盖	gega
舸	geiz
圪	gega
疙	geaa
饹	geqs
滆	gekn
袼	gets
哿	gesz
仡	geja
合	gejd
虼	geca
塥	gegn
给	gwid
跟	gfpi
根	gfei
哏	gfdi
艮	gfig
亘	gfff
茛	gfli
更	ggfb
梗	ggeb
羹	gggm
耿	ggqc
耕	ggaq
庚	ggxj
埂	gggb
哽	ggdb
赓	ggxo
暅	ggof
鲠	ggwb
浭	ggkb
颈	ggrw
绠	ggib
鹒	ggxx
𬒔	ggmv
共	gslh
供	gsjh
弓	gsbg
工	gsug
公	gshk
宫	gswd
攻	gsuh
功	gsus
拱	gsuh
龚	gsth
汞	gsuk
贡	gsuo
恭	gslh
巩	gsui
躬	gszb
肱	gsvk
觥	gsxm
蚣	gsck
珙	gsnh
䢼	gslt
硔	gsmh
狗	gzmg
够	gzgl
勾	gznk
钩	gzzk
购	gzok
沟	gzkk
苟	gzlg
构	gzek
垢	gzgd
篝	gzrg
遘	gzqu
彀	gzgr
诟	gzsd
觏	gzqe
媾	gzbg
枸	gzeg
姤	gzbd
雊	gzgu
鞲	gztg
句	gzgj
笱	gzrg
缑	gzio
佝	gzjg
岣	gzvg
耇	gzqg
故	guch
股	guvr
古	gucg
鼓	guhc
谷	guhg
骨	gufg
顾	guxw
钴	guzc
雇	gumu
孤	guhy
固	gurc
菇	gulc
姑	gubc
蛊	guca
箍	gurr
估	gujc
咕	gudc
瞽	guhq
沽	gukc
菰	guly
诂	gusc
辜	gucn
毂	gugr
榖	gugr
觚	guxy
贾	guvo
酤	guyc
锢	guzc
崮	guvc
堌	gugc
蛄	gucc
罟	guyc
汩	guko
鹘	gufx
轱	guyc
牯	guqc
嘏	gucr
梏	gued
鲴	guwc
呱	gudy
鹄	guqx
痼	guac
鸪	gucx
羖	gugr
瀔	gukr
臌	guvc
馉	guqf
牿	guqd
蓇	gulf
𦙶	guvc
挂	gxug
刮	gxap
瓜	gxyg
卦	gxgy
寡	gxwp
呱	gxdy
剐	gxdp
胍	gxvy
褂	gxty
栝	gxea
鸹	gxax
诖	gxsg
怪	gkhg
乖	gklv
拐	gkus
夬	gknj
掴	gkui
管	grrk
关	grhm
官	grwk
观	grre
馆	grqk
冠	grwk
灌	grku
罐	grau
棺	grek
贯	grko
惯	grho
毌	grku
倌	grjk
掼	gruo
瓘	grnu
祼	grfe
鹳	grlx
琯	grnk
鳏	grwk
筦	grrp
爟	grcu
盥	grpa
涫	grkk
纶	grij
莞	grlp
鳤	grwk
蒄	grlk
光	glmg
广	glxg
逛	glmu
咣	gldm
洸	glkm
桄	glem
犷	glmx
胱	glvm
垙	glgm
珖	glnm
𨐈	glym
贵	gvco
归	gvpb
鬼	gvag
柜	gven
跪	gvpz
轨	gvyk
硅	gvmg
龟	gvwg
桂	gveg
圭	gvgg
规	gvhe
诡	gvsz
瑰	gvna
珪	gvng
簋	gvra
癸	gvhm
妫	gvbi
邽	gvgt
鲑	gvwg
刿	gvvp
晷	gvod
闺	gvag
桧	gveb
刽	gvjp
鳜	gvwe
鬶	gvhn
宄	gvwk
庋	gvxc
匦	gvnk
皈	gvur
炅	gvoc
姽	gvbz
筀	gvrg
滚	gykk
棍	gyev
鲧	gywi
辊	gyyv
衮	gytk
绲	gyiv
磙	gymk
过	goku
国	gori
锅	gozj
郭	gogt
果	goqe
裹	gote
粿	gope
虢	goyz
椁	goeh
馘	gohf
腘	govi
掴	goui
馃	goqe
崞	govh
呙	godj
帼	gori
蝈	goci
聒	goqa
蜾	goce
涡	gokj
埚	gogj
𬇹	goki
哈	hadd
蛤	hacd
铪	hazd
还	hdcu
海	hdkk
嗨	hddk
害	hdwd
氦	hdvk
孩	hdhk
亥	hdkh
嗐	hddd
醢	hdya
骇	hdnk
骸	hdfk
咳	hddk
咍	hddd
胲	hdvk
含	hjjd
喊	hjdd
汉	hjkr
韩	hjng
汗	hjke
寒	hjww
邯	hjzt
函	hjam
憨	hjah
焊	hjce
旱	hjoe
焓	hjcd
悍	hjhe
罕	hjwe
涵	hjkm
翰	hjnz
憾	hjhh
酣	hjyz
撼	hjuh
瀚	hjkz
颔	hjjw
晗	hjod
捍	hjue
蚶	hjcz
鼾	hjoe
扞	hjue
菡	hjlm
邗	hjet
琀	hjnd
暵	hjoh
犴	hjme
顸	hjew
撖	hjuh
浛	hjkd
虷	hjce
㘎	hjdh
垾	hjge
崡	hjvm
嵅	hjvd
蔊	hjle
行	hhpx
杭	hheo
航	hhio
夯	hhms
沆	hhko
颃	hhzw
绗	hhip
巷	hhlv
吭	hhdo
好	hcbh
号	hcda
薅	hclk
耗	hcav
浩	hckd
豪	hcgj
壕	hcgj
嚎	hcdj
郝	hcgt
蚝	hccv
皓	hcud
蒿	hclg
毫	hcgv
昊	hcom
皞	hcun
濠	hckj
灏	hckw
貉	hcms
鄗	hcgt
淏	hckm
嗥	hcdn
颢	hcow
镐	hczg
嚆	hcdg
和	hexd
喝	hedf
核	heek
盒	heja
何	hejz
合	hejd
河	hekz
呵	hedz
贺	heso
鹤	hewx
赫	hegc
荷	helz
禾	hexh
阖	heaa
龁	hela
嗬	hedz
褐	hetf
曷	heof
颌	hejw
郃	hejt
盍	hega
涸	hekc
诃	hesz
鹖	heox
劾	heks
貉	hems
纥	heia
盉	hexa
壑	hegg
吓	hedy
龢	hejx
熇	hecg
菏	helz
饸	heqd
翮	henz
翯	hezg
阂	heak
垎	hegs
隺	hewu
鞨	hetf
𬌗	held
黑	hwph
嘿	hwdp
𬭶	hwzp
很	hfwi
恨	hfhi
狠	hfmi
痕	hfai
𬣳	hfsi
哼	hgdr
横	hgen
恒	hghf
衡	hgpw
亨	hggr
珩	hgnp
桁	hgep
蘅	hglw
鸻	hgpx
姮	hgbf
行	hgpx
堼	hggg
红	hsiu
烘	hsch
宏	hswk
哄	hsdh
轰	hsyr
虹	hscu
洪	hskh
鸿	hskx
薨	hslv
弘	hsbk
泓	hskk
纮	hsik
闳	hsak
吽	hsdq
竑	hsik
黉	hskn
翃	hsnz
訇	hsns
蕻	hslh
唝	hsdo
讧	hssu
荭	hslu
玒	hsnu
谼	hshh
𫟹	hszh
𬭎	hszk
后	hzxd
厚	hzxh
吼	hzda
侯	hzjo
猴	hzmo
候	hzjo
喉	hzdo
齁	hzog
鲎	hzkw
堠	hzgo
垕	hzxg
逅	hzxu
糇	hzpo
瘊	hzao
骺	hzfd
篌	hzro
郈	hzxt
鲘	hzwd
𬭤	hzzo
壶	hugc
户	humh
湖	hukv
胡	hucv
虎	huzh
乎	hutn
糊	hupv
和	huxd
互	hufb
呼	hudn
护	huum
沪	hukm
忽	hunh
弧	huby
狐	humy
唬	hudz
核	huek
斛	huxj
瑚	hunv
瓠	humy
縠	hugr
笏	hure
鹄	huqx
鄠	hutt
葫	hulv
煳	hucv
扈	humm
烀	hucn
祜	hufc
怙	huhc
惚	huhh
觳	hugr
鹘	hufx
岵	huvc
唿	hudh
冱	huwb
鹱	huxr
鳠	huwr
蝴	hucv
琥	hunz
淴	hukh
浒	hukn
鹕	hucx
醐	huyv
槲	huej
滹	hukn
囫	hure
戽	humj
嫭	hubn
轷	huyn
猢	humv
昈	huom
昒	huoe
花	hxlv
化	hxjv
画	hxfm
话	hxsa
滑	hxkf
华	hxjn
划	hxpp
哗	hxdn
桦	hxen
婳	hxbm
骅	hxnn
猾	hxmf
砉	hxam
铧	hxzn
觟	hxxg
坏	hkgc
怀	hkhc
淮	hkku
踝	hkpe
槐	hkea
徊	hkwd
换	hrum
还	hrcu
环	hrnc
患	hrdh
幻	hria
缓	hrir
欢	hrre
唤	hrdm
嬛	hrbt
桓	href
寰	hrwt
浣	hrkp
焕	hrcm
獾	hrmu
涣	hrkm
洹	hrkf
圜	hrrt
豢	hrhj
郇	hrnt
鲩	hrwp
奂	hrxm
宦	hrwq
萑	hrlu
逭	hrwu
擐	hrut
缳	hrit
鹮	hryx
澴	hrkt
镮	hrzt
漶	hrkh
鬟	hrpt
睆	hrqp
痪	hram
貆	hrmf
峘	hrvf
锾	hrzr
㬊	hror
荁	hrlf
𤩽	hrnm
𬘫	hrip
黄	hlnh
慌	hlho
皇	hlun
晃	hlom
荒	hllo
谎	hlso
簧	hlrn
煌	hlcn
篁	hlrn
凰	hlon
幌	hlrm
蝗	hlcn
恍	hlhm
滉	hlkm
遑	hluu
潢	hlkn
璜	hlnn
湟	hlkn
磺	hlmn
肓	hlfv
锽	hlzn
徨	hlwn
惶	hlhn
鳇	hlwn
隍	hltn
喤	hldn
艎	hlin
癀	hlan
蟥	hlcn
媓	hlbn
瑝	hlnn
㿠	hlum
𨱑	hlzn
会	hvjb
回	hvrd
灰	hvnc
毁	hvpr
汇	hvkn
惠	hvnh
茴	hvld
绘	hvib
挥	hvuy
辉	hvmy
悔	hvhk
慧	hvah
喙	hvdj
晖	hvoy
烩	hvcb
讳	hvsg
恢	hvhc
徽	hvwh
卉	hvnl
虺	hvfc
蕙	hvlh
秽	hvxl
麾	hvzv
晦	hvok
诲	hvsk
隳	hvth
恚	hvgh
荟	hvlb
浍	hvkb
洄	hvkd
翚	hvzy
贿	hvov
翙	hvvz
咴	hvdc
珲	hvny
蛔	hvcd
彗	hvab
哕	hvdl
诙	hvsc
袆	hvtg
橞	hveh
蟪	hvch
桧	hveb
溃	hvko
烠	hvcv
硊	hvmz
㧑	hvui
𬤝	hvsh
𬭬	hvzb
混	hykv
魂	hyba
婚	hybo
荤	hyly
浑	hyky
昏	hybo
溷	hykj
珲	hyny
阍	hyao
馄	hyqv
诨	hysy
惛	hyho
碈	hymo
或	hopf
活	hoka
火	hoch
货	hojo
获	holm
霍	hotu
嚯	hodu
祸	hofj
豁	howh
伙	hojc
和	hoxd
惑	hoph
镬	hozr
藿	holu
钬	hozc
濩	hokr
夥	hoql
嚄	hodr
蠖	hocr
攉	houu
漷	hokt
劐	holp
耠	hoad
佸	hoja
锪	hozh
㸌	hocu
𬴃	honm
及	jicj
即	jiiz
级	jiic
机	jieo
既	jiid
集	jiue
记	jisv
鸡	jirx
极	jiec
几	jioj
季	jixh
肌	jivo
基	jizg
急	jixh
系	jiti
继	jiia
挤	jiuq
计	jisn
剂	jiqp
给	jiid
寄	jiwz
姬	jibq
技	jiuc
祭	jihf
吉	jigd
寂	jiwr
籍	jiro
击	jium
纪	jiiv
忌	jivh
己	jivj
积	jixh
暨	jiif
辑	jiyq
脊	jiwv
疾	jiao
戟	jinp
箕	jirh
激	jikh
济	jikq
矶	jimo
叽	jido
迹	jizu
饥	jiqo
绩	jiio
冀	jiah
棘	jiem
藉	jilo
际	jitf
稷	jixh
妓	jibc
汲	jikc
蓟	jilp
伋	jijc
赍	jino
亟	jirf
髻	jipd
殛	jigf
鲫	jiwz
伎	jijc
稽	jixo
偈	jijf
畸	jiqz
霁	jitq
圾	jigc
嫉	jibo
讥	jiso
奇	jimz
笈	jirc
骥	jinh
嵴	jivv
唧	jidz
齑	jiqf
乩	jiya
戢	jidp
玑	jino
畿	jiiq
芰	jilc
嵇	jixv
洎	jiko
罽	jiyp
笄	jirl
楫	jieq
羁	jiyn
跻	jipq
麂	jixo
垍	jigo
姞	jibd
荠	jilq
蕺	jilp
屐	jicc
跽	jiph
觊	jive
漈	jikf
悸	jihh
缉	jiiq
剞	jimp
鲚	jiwq
觭	jixz
佶	jijd
掎	jiuz
岌	jivc
惎	jizh
耤	jiao
虮	jico
芨	jilc
瘠	jiav
期	jizv
蹐	jipv
犄	jiqz
穄	jixf
堲	jiig
蒺	jilo
墼	jiyg
瀱	jikp
鹡	jiwx
鱾	jiwv
㴔	jikh
徛	jiwz
枅	jiel
𪟝	jias
𫌀	jito
𫓯	jizg
𫓹	jizh
𬯀	jitq
𬶨	jiiw
𬶭	jiwf
加	jxsd
家	jxwj
假	jxjr
价	jxjp
甲	jxsj
架	jxse
夹	jxhh
贾	jxvo
嫁	jxbj
佳	jxjg
钾	jxzs
嘉	jxhd
伽	jxjd
驾	jxsn
痂	jxad
镓	jxzj
颊	jxhw
荚	jxlh
枷	jxed
迦	jxsu
葭	jxlr
岬	jxvs
珈	jxnd
斝	jxdj
笳	jxrd
郏	jxht
瘕	jxar
铗	jxzh
戛	jxfp
稼	jxxj
浃	jxkh
茄	jxld
胛	jxvs
槚	jxeo
跏	jxpd
蛱	jxch
袈	jxst
恝	jxah
泇	jxkd
𬂩	jxeh
间	jmao
见	jmej
件	jmjq
键	jmzu
剑	jmjp
兼	jmhc
建	jmbu
减	jmwd
煎	jmhc
捡	jmuf
箭	jmrp
剪	jmhp
肩	jmmv
简	jmro
尖	jmym
舰	jmie
贱	jmop
健	jmju
碱	jmmd
歼	jmgl
茧	jmlc
监	jmpa
荐	jmlh
溅	jmkp
渐	jmkt
拣	jmuy
检	jmef
僭	jmjo
谏	jmsh
奸	jmbe
坚	jmpg
鉴	jmpz
笺	jmrp
涧	jmko
践	jmpp
蹇	jmwp
艰	jmri
翦	jmhz
菅	jmlk
俭	jmjf
柬	jmxh
缄	jmid
腱	jmvu
笕	jmre
缣	jmic
锏	jmzo
睑	jmqf
戋	jmfp
鞬	jmtu
謇	jmws
湔	jmkp
踺	jmpu
犍	jmqu
裥	jmto
槛	jmea
蒹	jmlc
搛	jmuc
鲣	jmwg
枧	jmee
戬	jmfp
鹣	jmhx
楗	jmeu
暕	jmoh
谫	jmsp
毽	jmvu
趼	jmpl
篯	jmrp
饯	jmqp
鞯	jmth
牮	jmjq
鳒	jmwc
𬣡	jmsp
将	jlak
讲	jlsq
奖	jlam
酱	jlay
姜	jlgb
江	jlku
降	jltv
蒋	jllk
僵	jljf
匠	jlnt
桨	jlae
浆	jlak
犟	jlbq
绛	jliv
疆	jlbf
缰	jlif
鳉	jlwk
豇	jlzu
洚	jlkv
强	jlbc
耩	jlag
弶	jlby
虹	jlcu
糨	jlpc
礓	jlmf
茳	jllu
膙	jlvc
叫	jndi
交	jnab
较	jnyb
教	jnqh
脚	jnvz
角	jnxt
胶	jnvb
浇	jnkp
缴	jnih
焦	jnuc
搅	jnue
嚼	jndk
窖	jned
椒	jner
娇	jnbp
绞	jnib
跤	jnpb
鲛	jnwb
轿	jnyp
矫	jnop
剿	jnop
蛟	jncb
徼	jnwh
骄	jnnp
礁	jnmc
饺	jnqb
蕉	jnlc
铰	jnzb
狡	jnmb
皎	jnub
郊	jnat
湫	jnkc
姣	jnbb
酵	jnyh
滘	jnkd
校	jneb
鹪	jnux
醮	jnyc
皦	jnuh
觉	jnke
敫	jnuh
艽	jnlk
茭	jnlb
峤	jnvp
佼	jnjb
璬	jnnh
燋	jncc
侥	jnjp
斠	jnqj
皭	jnuk
峧	jnvb
藠	jnlu
噍	jndc
漖	jnkh
僬	jnjc
恔	jnhb
䴔	jnax
届	jpcd
界	jpqp
接	jpub
借	jpjo
皆	jpvu
解	jpxq
节	jplz
姐	jpbf
街	jppg
结	jpid
截	jpnu
杰	jpec
劫	jpgs
戒	jppl
阶	jptp
揭	jpuf
介	jpjp
蚧	jpcp
洁	jpkd
捷	jpus
芥	jplp
藉	jplo
嗟	jpdu
诘	jpsd
羯	jpgf
桀	jple
竭	jpif
价	jpjp
桔	jped
颉	jpgw
疖	jpaz
孑	jprf
诫	jpsl
婕	jpbs
玠	jpnp
疥	jpap
睫	jpqs
碣	jpmf
絜	jpai
劼	jpgs
秸	jpxd
拮	jpud
檞	jpeq
骱	jpfp
湝	jpku
楷	jpeu
蜐	jpcs
鲒	jpwd
讦	jpse
喈	jpdu
悈	jphl
褯	jptr
岊	jpmv
㛃	jpab
进	jbqu
近	jbtu
仅	jbjr
金	jbzj
斤	jbtj
今	jbja
尽	jbcw
劲	jbrs
紧	jbpi
晋	jbfo
禁	jbef
筋	jbrs
津	jbkb
巾	jbrj
锦	jbzr
浸	jbkr
堇	jbla
谨	jbsa
靳	jbtt
槿	jbea
衿	jbta
瑾	jbna
烬	jbcw
襟	jbtf
矜	jbia
瑨	jbno
噤	jbdf
溍	jbko
缙	jbio
觐	jble
祲	jbfr
妗	jbba
馑	jbqa
浕	jbkw
赆	jbow
荩	jblw
殣	jbga
珒	jbnb
廑	jbxa
琎	jbnu
墐	jbga
卺	jbaz
𬬱	jbzt
经	jkiu
竟	jkxp
精	jkpv
镜	jkzp
净	jkwb
静	jkab
竞	jkip
景	jkoy
井	jkqj
敬	jklh
京	jkgy
鲸	jkwy
惊	jkhy
颈	jkrw
警	jkls
境	jkgp
茎	jklu
荆	jklp
径	jkwu
靖	jkiv
菁	jklv
晶	jkoo
睛	jkqv
璟	jkny
胫	jkvu
粳	jkpb
阱	jktq
劲	jkrs
旌	jkll
肼	jkvq
泾	jkku
丼	jkqi
婧	jkbv
竫	jkib
迳	jkru
儆	jkjh
腈	jkvv
憬	jkhy
痉	jkau
倞	jkjy
刭	jkrp
靓	jkae
獍	jkmp
兢	jkcp
鼱	jkpv
汫	jkkq
璥	jknh
麖	jkxy
猄	jkmy
䴖	jkax
囧	jsrm
冏	jsmd
炯	jscd
迥	jsmu
窘	jsed
扃	jsmd
颎	jsvw
炅	jsoc
坰	jsgd
泂	jskd
䌹	jsid
𬳶	jsnd
就	jqgo
酒	jqky
旧	jqgo
救	jqfh
九	jqkj
久	jqxi
揪	jquc
灸	jqxc
鸠	jqkx
啾	jqdc
玖	jqni
韭	jqrf
纠	jqii
舅	jqps
究	jqek
咎	jqhd
臼	jqpj
鹫	jqgx
厩	jqxd
僦	jqjo
柩	jqei
疚	jqai
氿	jqkk
鬏	jqpc
阄	jqaw
赳	jqpi
桕	jqep
㠇	jqvo
据	juuc
剧	jucp
局	jucd
句	jugj
举	juku
距	jupn
聚	juqk
巨	junn
居	jucc
具	juqh
拒	juun
狙	jumf
俱	jujh
菊	julp
锯	juzc
焗	jucd
橘	jued
车	juyc
惧	juhh
車	juyc
矩	juon
钜	juzn
鞠	jutp
遽	juzu
拘	juug
沮	jukf
驹	jung
莒	juld
掬	juup
踞	jupc
桔	jued
锔	juzd
苴	julf
炬	jucn
讵	jusn
咀	judf
琚	junc
裾	jutc
椐	juec
鞫	juts
秬	juxn
屦	jucb
倨	jujc
雎	jufu
娵	jubr
苣	juln
疽	juaf
榉	jueu
筥	jurd
蒟	julg
窭	jueb
醵	juyj
飓	juoh
龃	julf
崌	juvc
柜	juen
泃	jukg
砠	jumf
踽	jupv
犋	juqh
岨	juvf
枸	jueg
趄	jupf
澽	jukj
岠	juvn
腒	juvc
弆	jugl
䴗	juqx
𬶋	juwg
卷	jrhz
捐	jruv
圈	jrrz
绢	jriv
涓	jrkv
娟	jrbv
倦	jrjz
隽	jruv
狷	jrmv
镌	jrzv
蠲	jrkc
鹃	jrdx
鄄	jrvt
眷	jrhq
焆	jrcv
锩	jrzz
桊	jrhe
绝	jtim
觉	jtke
嚼	jtdk
决	jtwj
撅	jtue
倔	jtjm
爵	jtyk
掘	jtum
角	jtxt
厥	jtxe
诀	jtsj
珏	jtni
玦	jtnj
蕨	jtle
蹶	jtpe
噘	jtde
崛	jtvm
攫	jtur
谲	jtsd
橛	jtee
抉	jtuj
傕	jtju
玃	jtmr
爝	jtck
孓	jtri
桷	jtet
觖	jtxj
矍	jtqr
獗	jtme
镢	jtze
劂	jtxp
砄	jtmj
㵐	jtke
𫔎	jtzd
𫘝	jtnj
均	jygw
君	jybd
军	jywy
郡	jybt
菌	jylx
俊	jyjh
钧	jyzw
峻	jyvh
骏	jynh
浚	jykh
珺	jynd
畯	jyqh
竣	jyih
麇	jyxx
焌	jych
皲	jywr
晙	jyoh
莙	jyld
筠	jyrw
捃	jyud
龟	jywg
隽	jyuv
葰	jylh
鲪	jywd
䐃	jyvx
卡	kayy
咯	kads
咖	kadd
咔	kady
喀	kads
胩	kavy
开	kdfl
凯	kdvo
铠	kdzv
恺	kdhv
揩	kduu
楷	kdeu
锎	kdzl
慨	kdhd
闿	kdav
锴	kdzu
忾	kdhv
垲	kdgv
炌	kdcp
剀	kdvp
蒈	kdlu
看	kjuq
砍	kjme
坎	kjge
刊	kjep
堪	kjga
槛	kjea
侃	kjjo
勘	kjzs
龛	kjjt
阚	kjah
戡	kjzp
瞰	kjqh
莰	kjle
衎	kjpe
磡	kjms
崁	kjve
嵁	kjva
墈	kjgs
抗	khuo
扛	khuu
康	khxk
炕	khco
糠	khpk
钪	khzo
慷	khhk
亢	khzo
伉	khjo
闶	khao
𡐓	khgk
𩾌	khwk
靠	kcqr
考	kcqa
烤	kcca
拷	kcua
尻	kcck
铐	kcza
犒	kcqg
栲	kcea
洘	kcka
㸆	kccr
可	kezk
课	kese
克	kecp
科	kexj
客	kews
氪	kevp
颗	keqw
壳	kego
磕	kema
刻	kekp
咳	kedk
柯	keez
嗑	keda
珂	kenz
棵	keee
渴	kekf
恪	kehs
颏	kekw
苛	kelz
窠	keee
轲	keyz
髁	kefe
疴	keaz
瞌	keqa
坷	kegz
蝌	kecj
缂	keit
锞	keze
骒	kene
炣	kecz
岢	kevz
溘	keka
稞	kexe
匼	kend
牁	keaz
剋	kwcp
啃	kfdv
肯	kfsv
垦	kfig
恳	kfih
裉	kfti
坑	kggo
吭	kgdo
铿	kgzg
硁	kgmu
空	kseu
孔	ksha
控	ksuu
恐	ksuh
崆	ksvu
硿	ksmu
箜	ksru
倥	ksju
埪	ksgu
口	kzdk
扣	kzud
抠	kzub
寇	kzwh
叩	kzdz
蔻	kzlh
芤	kzla
筘	kzrd
眍	kzqb
𫸩	kzbb
库	kuxy
哭	kudm
苦	kulc
酷	kuyd
裤	kuty
枯	kuec
窟	kuem
喾	kukd
刳	kump
骷	kufc
绔	kuia
矻	kuma
圐	kurl
跨	kxpa
夸	kxma
垮	kxga
胯	kxva
挎	kxua
侉	kxja
姱	kxba
快	kkhj
块	kkgj
会	kkjb
筷	kkrj
哙	kkdb
脍	kkvb
郐	kkjt
侩	kkjb
蒯	kklp
鲙	kkwb
浍	kkkb
狯	kkmb
㧟	kkun
款	krge
宽	krwe
髋	krfe
狂	klmn
框	klen
矿	klmx
筐	klrn
况	klwp
哐	kldn
匡	klnn
旷	klox
诓	klsn
邝	klxt
诳	klsn
眶	klqn
圹	klgx
贶	klop
纩	klix
夼	klmo
洭	klkn
𫛭	klmx
亏	kvma
奎	kvmg
窥	kvee
蝰	kvcg
盔	kvna
葵	kvlm
夔	kvhh
魁	kvaj
匮	kvno
愧	kvha
溃	kvko
揆	kvum
馈	kvqo
逵	kvgu
愦	kvho
傀	kvja
睽	kvqm
櫆	kvej
馗	kvko
骙	kvnm
聩	kvqo
跬	kvpg
煃	kvcg
悝	kvhd
戣	kvhp
喟	kvdv
喹	kvdg
蒉	kvlo
篑	kvro
岿	kvvb
暌	kvom
𫠆	kvcw
困	kyre
坤	kygg
捆	kyue
昆	kyov
鲲	kywv
堃	kylg
琨	kynv
髡	kypp
鹍	kyox
焜	kycv
阃	kyae
醌	kyyv
悃	kyhe
锟	kyzv
壸	kygc
裈	kyty
婫	kybv
扩	koux
阔	koaa
括	koua
廓	koxt
蛞	koca
啦	ladi
拉	laui
辣	lanx
剌	laxp
蜡	laco
腊	lavo
喇	ladp
菈	lali
垃	lagi
落	lals
邋	laou
镴	lazp
旯	laok
蝲	lacp
揦	laup
瘌	laap
砬	lami
鞡	lati
𬶟	lawp
来	ldah
莱	ldlh
赖	ldxo
铼	ldzh
濑	ldko
赉	ldao
徕	ldwh
癞	ldao
涞	ldkh
睐	ldqh
崃	ldvh
籁	ldro
俫	ldjh
梾	ldeh
烂	ljct
蓝	ljla
懒	ljho
兰	ljht
栏	ljet
揽	ljue
拦	ljut
篮	ljra
岚	ljvb
滥	ljka
览	ljpe
澜	ljkh
榄	ljee
阑	ljah
镧	ljzh
缆	ljie
婪	ljeb
褴	ljta
斓	ljvh
谰	ljsh
罱	ljyg
襕	ljth
漤	ljkb
𬒗	ljme
狼	lhmi
浪	lhki
郎	lhit
朗	lhiv
廊	lhxt
啷	lhdt
琅	lhni
烺	lhci
螂	lhct
崀	lhvi
阆	lhai
锒	lhzi
榔	lhet
桹	lhei
埌	lhgi
塱	lhig
莨	lhli
蒗	lhli
稂	lhxi
筤	lhri
㫰	lhoi
㮾	lhie
蓢	lhlv
老	lcql
捞	lcus
佬	lcjq
唠	lcds
劳	lcls
牢	lcwq
烙	lccs
铑	lczq
姥	lcbq
涝	lcks
醪	lcye
酪	lcys
落	lcls
痨	lcas
铹	lczs
嫪	lcbe
崂	lcvs
栳	lceq
荖	lclq
络	lcis
耢	lcas
𫭼	lcgs
了	lerl
乐	leby
勒	lets
叻	leds
仂	lejs
鳓	lews
簕	lers
饹	leqs
泐	leks
嘞	leds
类	lwpm
累	lwqi
雷	lwtq
泪	lwkq
嘞	lwds
垒	lwkg
勒	lwts
蕾	lwlq
镭	lwzq
肋	lwvs
磊	lwmm
擂	lwuq
罍	lwqa
诔	lwsa
羸	lwfi
酹	lwyk
耒	lwal
嫘	lwbi
缧	lwii
儡	lwjq
藟	lwlq
檑	lweq
礌	lwmq
癗	lwaq
冷	lgwk
楞	lgel
愣	lghl
棱	lgeh
崚	lgvh
塄	lggl
堎	lggh
里	lidl
离	lizv
力	lisl
李	lieh
例	lijp
利	lixp
理	lind
立	liil
礼	lifa
粒	lipi
梨	lixe
历	lixs
锂	lizd
丽	lifv
哩	lirg
黎	lixk
栗	live
莉	lilp
吏	lifb
戾	limm
藜	lilk
鲤	liwd
厘	lixd
笠	liri
犁	lixq
璃	linv
狸	limd
厉	lixp
隶	libk
栎	liey
骊	linv
荔	lils
沥	liks
俪	lijv
励	lixs
砾	limy
醴	liyz
砺	limp
澧	likz
詈	liys
鬲	ling
痢	liap
罹	liyu
疠	liap
莅	lili
俚	lijd
郦	lift
喱	lidd
篱	lirv
鳢	liwz
漓	likv
浬	lieg
轹	liyy
俐	lijp
蓠	lilv
蛎	licp
蠡	libc
唳	lidm
呖	lids
溧	like
蜊	licp
鲡	liwv
醨	liyv
嫠	liab
凓	liwe
枥	lies
逦	lifu
娌	libd
粝	lipp
鹂	lifx
苈	lils
黧	lixp
缡	liiv
傈	lije
坜	ligs
疬	lias
跞	lipy
朸	lies
珕	lins
浰	likp
雳	lits
猁	limp
篥	lire
㰀	liek
𫵷	livs
𬍛	liny
俩	lxjm
连	lmyu
练	lmiy
脸	lmvf
链	lmzu
联	lmqm
恋	lmzh
莲	lmlu
帘	lmer
炼	lmcy
镰	lmzc
敛	lmjh
怜	lmhk
廉	lmxc
涟	lmku
濂	lmkc
殓	lmgf
蠊	lmcc
琏	lmnu
楝	lmeh
鲢	lmwu
奁	lmmb
蔹	lmlh
裢	lmtu
潋	lmkh
梿	lmeu
浰	lmkp
裣	lmtf
瑓	lmnh
𬶠	lmwh
量	llod
两	llml
亮	llgo
梁	llke
辆	llym
凉	llwy
粮	llpi
良	llii
晾	lloy
靓	llae
俩	lljm
谅	llsy
粱	llkp
椋	lley
俍	llji
魉	llam
墚	llge
莨	llli
踉	llpi
辌	llyy
悢	llhi
𫟅	lliy
𬜯	lllm
聊	lnqb
撩	lnuy
料	lnpj
辽	lnru
廖	lnxe
撂	lnus
寮	lnwy
疗	lnar
蓼	lnle
瞭	lnqy
钌	lnzr
燎	lncy
了	lnrl
獠	lnmy
潦	lnky
僚	lnjy
憭	lnhy
髎	lnfe
寥	lnwe
嘹	lndy
橑	lney
嫽	lnby
缭	lniy
镣	lnzy
尥	lnoi
蹽	lnpy
漻	lnke
鹩	lnmx
簝	lnry
𪤗	lnge
列	lpgp
咧	lpdp
猎	lpmo
烈	lpgc
裂	lpgt
劣	lpys
鬣	lppp
洌	lpkp
冽	lpwp
埒	lpgk
躐	lppp
捩	lpum
趔	lppp
峛	lpvp
脟	lpvk
䴕	lpgx
𫚭	lpwp
林	lbee
拎	lbuk
临	lbpo
磷	lbmv
琳	lbne
凛	lbwf
淋	lbke
霖	lbte
鳞	lbwv
邻	lbjt
麟	lbxv
璘	lbnv
廪	lbxf
赁	lbjo
蔺	lblu
吝	lbvd
檩	lbef
懔	lbhf
膦	lbvv
潾	lbkv
粼	lbpo
嶙	lbvv
躏	lbpu
啉	lbde
遴	lbpu
辚	lbyv
箖	lbre
瞵	lbqv
翷	lbpz
𬭸	lbzv
𬴊	lbnv
另	lkds
令	lkjk
零	lktk
领	lkjw
铃	lkzk
灵	lkbc
玲	lknk
岭	lkvk
陵	lkth
凌	lkwh
龄	lklk
绫	lkih
翎	lkjz
聆	lkqk
泠	lkkk
澪	lkkk
伶	lkjk
蛉	lkck
菱	lklh
苓	lklk
姈	lkbk
羚	lkgk
呤	lkdk
瓴	lkjr
棂	lkec
祾	lkfh
鲮	lkwh
舲	lkik
棱	lkeh
酃	lktt
坽	lkgk
囹	lkrk
柃	lkek
〇	lkdk
鸰	lkjx
昤	lkok
㥄	lkhh
六	lqal
留	lqbq
流	lqko
刘	lqvp
溜	lqkq
柳	lqeb
硫	lqmo
遛	lqbu
瘤	lqaq
镠	lqze
琉	lqno
熘	lqcq
浏	lqkp
绺	lqid
榴	lqeq
旒	lqlo
陆	lqtm
鎏	lqkz
骝	lqnq
馏	lqqq
镏	lqzq
锍	lqzo
珋	lqnb
疁	lqqe
罶	lqyq
鹨	lqzx
瑬	lqki
飗	lqoq
碌	lqmk
鹠	lqbx
咯	lods
龙	lstl
隆	lstl
泷	lskt
拢	lsut
笼	lsrt
陇	lstt
聋	lstq
珑	lsnt
胧	lsvt
垄	lstg
茏	lslt
栊	lset
砻	lstm
咙	lsdt
哢	lsdl
癃	lsal
窿	lsel
昽	lsot
弄	lsnl
漋	lskl
眬	lsqt
𬕂	lsro
楼	lzeb
喽	lzdb
漏	lzkt
搂	lzub
娄	lzpb
瘘	lzab
露	lzts
篓	lzrb
镂	lzzb
陋	lzta
蒌	lzlb
耧	lzab
蝼	lzcb
偻	lzjb
溇	lzkb
髅	lzfb
嵝	lzvb
䁖	lzqb
剅	lzzp
𦝼	lzvb
𪣻	lzgb
路	lups
录	lubk
撸	luuo
陆	lutm
鲁	luwo
鹿	luxl
卢	luyc
露	luts
卤	luyb
炉	lucm
虏	luzs
噜	ludo
麓	luex
掳	luus
禄	lufk
戮	luzp
庐	luxm
垆	lugc
橹	lueo
璐	luns
芦	lulm
潞	luks
颅	luyw
泸	lukc
鹭	lupx
胪	luvc
渌	lukk
镥	luzo
赂	luos
鲈	luwc
菉	lulk
簏	lurx
蕗	luls
碌	lumk
漉	lukx
僇	luje
栌	luec
箓	lurk
辂	luys
舻	luic
琭	lunk
辘	luyx
逯	lubu
鸬	luyx
甪	lutt
绿	luik
轳	luyc
勠	luzs
澛	luko
氇	luvo
稑	luxg
𫘧	lunk
𬬻	luzc
乱	lraa
卵	lrbl
鸾	lrzx
栾	lrze
銮	lrzz
峦	lrzv
娈	lrzb
挛	lrzu
脔	lrzj
孪	lrzh
滦	lrke
论	lysj
轮	lyyj
抡	lyuj
伦	lyjj
仑	lyjl
纶	lyij
沦	lykj
囵	lyrj
𫭢	lygj
𬬭	lyzj
罗	loyl
落	lols
咯	lods
洛	loks
裸	lote
啰	lodl
骆	lons
摞	loui
螺	loci
络	lois
骡	loni
锣	lozl
萝	loll
雒	losu
珞	lons
逻	loyu
蠃	lofi
箩	lorl
烙	locs
泺	loky
荦	lolq
漯	loki
捋	louk
倮	loje
椤	loel
瘰	loai
猡	loml
蓏	loly
脶	lovj
率	lvzn
绿	lvik
铝	lvzd
吕	lvdd
驴	lvnm
旅	lvlt
律	lvwb
捋	lvuk
氯	lvvk
屡	lvcb
滤	lvkh
虑	lvzh
履	lvch
缕	lvib
侣	lvjd
闾	lvad
膂	lvlv
梠	lved
榈	lved
褛	lvtb
偻	lvjb
稆	lvxd
葎	lvlb
垏	lvgb
𦝼	lvvb
略	ltqs
掠	ltuy
锊	ltzk
圙	ltrb
䂮	ltam
吗	madn
嘛	madz
骂	madn
马	manm
码	mamn
妈	mabn
麻	mazm
玛	mann
蚂	macn
抹	maue
蟆	macm
祃	mafn
犸	mamn
摩	mazu
杩	maen
买	mdam
卖	mdnm
麦	mdah
埋	mdgd
迈	mdfu
脉	mdvk
霾	mdtd
唛	mddh
劢	mdfs
荬	mdlm
鿏	mdzh
慢	mjhr
满	mjkm
蛮	mjzc
曼	mjor
漫	mjkr
螨	mjcm
瞒	mjqm
蔓	mjlr
幔	mjrr
鳗	mjwr
缦	mjir
馒	mjqr
谩	mjsr
鬘	mjpr
墁	mjgr
嫚	mjbr
镘	mjzr
颟	mjlw
鞔	mjtp
埋	mjgd
𬜬	mjld
忙	mhhf
盲	mhfq
莽	mhll
芒	mhlf
氓	mhfd
蟒	mhcl
茫	mhlf
邙	mhft
漭	mhkl
尨	mhoe
牻	mhqe
牤	mhqf
厖	mhxe
杧	mhef
硭	mhmf
猫	mcmq
毛	mcvm
冒	mcoq
帽	mcrq
锚	mczq
贸	mcbo
矛	mcit
卯	mcbm
茅	mclt
貌	mcmp
昴	mcob
茂	mcln
冇	mcnm
旄	mclv
峁	mcvb
髦	mcpv
铆	mczb
耄	mcqv
楙	mcee
懋	mceh
芼	mclv
瑁	mcnq
牦	mcqv
茆	mclb
袤	mctt
瞀	mciq
泖	mckb
眊	mcqv
鄚	mclt
蝥	mcic
蟊	mcic
么	metk
没	mwkr
每	mwek
美	mwgm
枚	mweh
梅	mwek
酶	mwyk
妹	mwba
煤	mwce
霉	mwtk
镁	mwzm
眉	mwcq
魅	mwaa
玫	mwnh
媚	mwbq
昧	mwoa
媒	mwbe
莓	mwlk
镅	mwzq
郿	mwct
寐	mwwa
湄	mwkq
浼	mwkp
袂	mwtj
楣	mweq
鹛	mwcx
渼	mwkm
瑂	mwnq
糜	mwzp
媄	mwbm
嵋	mwvq
们	mfja
门	mfam
焖	mfch
闷	mfah
扪	mfua
钔	mfza
呇	mfkd
懑	mfkh
𫞩	mfnm
梦	mgel
猛	mgma
萌	mglv
蒙	mglj
懵	mghq
孟	mgha
锰	mgza
盟	mgoa
濛	mgkj
獴	mgmj
勐	mghs
虻	mgcf
檬	mgej
蠓	mgcj
甍	mglr
艋	mgia
朦	mgvj
瞢	mglq
幪	mgrj
艨	mgij
蜢	mgca
礞	mgmj
㠓	mgvj
鹲	mglx
𫑡	mgdt
米	mipm
迷	mipu
密	miwv
谜	misu
蜜	miwc
咪	midp
弥	miby
觅	miye
幂	miwr
蘼	milr
芈	migy
秘	mixt
靡	mizr
眯	miqp
糜	mizp
醚	miyu
祕	mift
祢	mify
弭	mibq
麋	mixp
泌	mikt
汨	miko
宓	miwt
谧	misa
脒	mivp
蓂	mila
醾	miyp
縻	mizi
猕	mimy
敉	miph
洣	mikp
嘧	midv
面	mmbm
免	mmwp
棉	mmer
眠	mmqd
缅	mmib
绵	mmir
勉	mmws
冕	mmop
沔	mmka
眄	mmqa
丏	mmfa
勔	mmbs
愐	mmhb
娩	mmbp
湎	mmkb
腼	mmvb
偭	mmjb
渑	mmkd
𩾃	mmwp
秒	mnxt
喵	mndq
庙	mnxd
妙	mnbt
瞄	mnqq
苗	mnlq
描	mnuq
淼	mnkk
渺	mnkt
眇	mnqt
缈	mnit
杪	mnet
邈	mnmu
藐	mnlp
缪	mnie
鹋	mnlx
灭	mpfc
咩	mpdg
乜	mpaa
蔑	mpli
篾	mpri
民	mbdm
敏	mbeh
皿	mbam
抿	mbud
闽	mbac
泯	mbkd
闵	mbav
缗	mbio
旻	mbov
愍	mbdh
湣	mbko
珉	mbnd
悯	mbhv
岷	mbvd
鳘	mbew
黾	mbdm
忞	mbvh
苠	mbld
名	mkld
命	mkjz
明	mkov
鸣	mkdx
茗	mkld
冥	mkwa
铭	mkzd
暝	mkoa
洺	mkkd
溟	mkka
瞑	mkqa
酩	mkyd
螟	mkca
谬	mqse
缪	mqie
莫	molm
磨	mozm
魔	moza
摸	moum
膜	movm
末	mofe
抹	moue
麽	mozk
墨	mopg
没	mokr
摩	mozu
默	mopm
模	moem
馍	moqm
沫	moke
摹	molu
殁	mogr
陌	motu
茉	mole
谟	mosm
貘	momm
漠	mokm
貊	momu
镆	mozm
蘑	molm
秣	moxe
蓦	moln
寞	mowm
万	mofp
瘼	moam
嬷	mobk
耱	moam
无	modu
脉	movk
嫫	mobm
靺	mote
藦	molu
𬙊	moig
某	mzze
谋	mzse
牟	mzkq
缪	mzie
眸	mzqq
哞	mzdq
侔	mzjq
鍪	mziz
蛑	mzcq
木	muem
目	muqm
墓	mulg
姆	mubk
母	mukm
穆	muxe
沐	muke
亩	muzq
牧	muqh
暮	mulo
模	muem
慕	mulh
幕	mulr
钼	muzq
募	muls
拇	muuk
睦	muqg
牡	muqg
呒	mudd
苜	mulq
牟	mukq
仫	mujk
毪	muvq
𧿹	mupk
𬭁	muzk
那	naat
拿	naju
哪	nadt
呐	nadj
娜	nabt
纳	naij
钠	nazj
捺	nauf
镎	nazu
衲	natj
乸	naek
南	nang
肭	navj
𦰡	nalt
乃	ndvn
奶	ndbv
耐	ndlk
奈	ndmf
氖	ndvv
萘	ndlf
柰	ndef
迺	ndvu
艿	ndlv
鼐	ndva
耏	ndle
佴	ndjq
难	njru
男	njqs
南	njng
楠	njeg
喃	njdg
腩	njvg
囡	njrb
赧	njgr
蝻	njcg
婻	njbg
萳	njlg
囊	nhnt
馕	nhqt
曩	nhof
攮	nhut
齉	nhot
囔	nhdt
脑	ncvm
闹	ncar
挠	ncup
恼	nchm
淖	nckn
瑙	ncnb
孬	ncch
铙	nczp
垴	ncgm
呶	ncdr
猱	ncme
臑	ncvl
蛲	nccp
硇	ncmb
峱	ncmv
呢	nedv
讷	nesj
哪	nedt
内	nwmj
馁	nwqb
嫩	nfbh
恁	nfjh
能	ngkv
你	nijy
尼	nicv
逆	nihu
泥	nikv
拟	niuj
匿	nind
腻	nivo
妮	nibv
倪	nijp
呢	nidv
溺	nikw
铌	nizv
昵	niov
霓	nitp
睨	niqp
伲	nijv
鲵	niwp
猊	nimp
旎	nilv
麑	nixp
坭	nigv
怩	nihv
薿	nilt
𨺙	nitp
𫐐	niyp
𫠜	nilp
年	nmev
念	nmjh
黏	nmxd
碾	nmmt
撵	nmuy
捻	nmuh
辇	nmhy
蔫	nmlc
鲶	nmwh
拈	nmud
廿	nmln
鲇	nmwd
埝	nmgh
粘	nmpd
娘	nlbi
酿	nlyi
嬢	nlbf
鸟	nnxn
尿	nnck
茑	nnlx
脲	nnvk
袅	nnxt
捏	npug
镍	npze
涅	npkg
聂	npqr
孽	nplh
镊	npzr
颞	npqw
蹑	nppr
臬	npoe
啮	npdl
蘖	nple
嗫	npdr
乜	npaa
嵲	npve
菍	nplh
糵	nplp
陧	nptg
𫔶	npae
您	nbjh
拧	nkua
宁	nkwa
凝	nkwt
甯	nkwt
狞	nkma
柠	nkea
苧	nkla
佞	nkjb
泞	nkka
咛	nkda
聍	nkqa
牛	nqqn
扭	nqug
妞	nqbg
纽	nqig
钮	nqzg
拗	nqus
狃	nqmg
杻	nqeg
忸	nqhg
弄	nsnl
浓	nskt
农	nswt
侬	nsjt
脓	nsvt
秾	nsxt
哝	nsdt
𬪩	nsyt
耨	nzak
怒	nubh
努	nubs
弩	nubb
奴	nubr
驽	nubn
傉	nujk
孥	nubh
砮	nubm
胬	nubj
笯	nurr
暖	nror
诺	nosd
挪	nout
糯	nopl
喏	nodd
傩	noju
懦	nohl
搦	nouw
锘	nozd
娜	nobt
𦰡	nolt
女	nvbn
钕	nvzb
衄	nvtg
恧	nvlh
虐	ntzb
疟	ntab
哦	oodp
噢	oodm
喔	oody
欧	oune
藕	oulv
偶	oujv
呕	oudb
区	ounb
鸥	ounx
沤	oukb
殴	ounr
耦	ouav
讴	ousb
瓯	ounr
怄	ouhb
𠙶	ourm
𬉼	oucb
怕	pahu
爬	paym
趴	paph
啪	padu
帕	paru
扒	pauh
耙	paam
葩	palm
琶	panm
杷	paem
舥	paim
潖	pakm
筢	parm
拍	pduu
派	pdkt
牌	pdan
排	pdur
湃	pdka
俳	pdjr
徘	pdwr
哌	pddt
迫	pduu
蒎	pdlt
簰	pdrn
盘	pjia
判	pjhp
潘	pjkq
畔	pjqu
攀	pjeu
盼	pjqp
叛	pjhr
爿	pjap
磐	pjim
袢	pjtu
槃	pjie
蟠	pjcq
泮	pjku
襻	pjtu
胖	pjvu
番	pjtq
磻	pjmq
蹒	pjpm
旁	phil
胖	phvu
庞	phxt
彷	phwl
磅	phml
滂	phkl
乓	phti
逄	phhu
螃	phcl
耪	phal
雱	phtl
鳑	phwl
膀	phvl
跑	pcpv
泡	pckv
炮	pccv
抛	pcus
刨	pcnp
袍	pctv
匏	pcmv
庖	pcxv
咆	pcdv
狍	pcmv
疱	pcav
脬	pcvh
配	pwyv
赔	pwod
陪	pwtd
佩	pwjr
呸	pwdf
胚	pwvf
裴	pwrt
培	pwgd
醅	pwyd
珮	pwnr
沛	pwkr
辔	pwid
旆	pwlr
锫	pwzd
帔	pwrr
霈	pwtr
衃	pwtc
喷	pfdo
盆	pfha
湓	pfka
捧	pguu
碰	pgmc
彭	pghe
砰	pgmh
棚	pgev
硼	pgmv
朋	pgvv
鹏	pgvx
烹	pggc
嘭	pgde
蓬	pglu
膨	pgve
篷	pgru
澎	pgke
芃	pgli
抨	pguh
椪	pgec
怦	pghh
弸	pgbv
堋	pggv
淜	pgkv
蟛	pgce
搒	pgul
皮	pirp
屁	picv
批	piuv
劈	picp
匹	pinp
啤	pidn
脾	pivn
癖	pian
披	piur
辟	picn
铍	pizr
丕	picf
疲	piar
毗	piqv
痞	piad
坯	pigf
嚭	pihd
僻	pijn
罴	piyc
譬	pics
噼	pidn
琵	pinv
貔	pimv
蜱	picn
圮	pigv
陂	pitr
邳	pict
郫	piut
伾	pijf
裨	pitn
霹	pitn
媲	pibv
鼙	pihn
陴	pitn
甓	picr
睥	piqn
埤	pign
淠	pikl
椑	pien
狉	pimf
澼	pikn
枇	piev
砒	pimv
蚍	picv
纰	piiv
仳	pijv
否	picd
鲏	piwr
䴙	picx
苉	pilp
𬳵	pinf
篇	pmri
偏	pmji
片	pmap
骗	pmni
骈	pmnl
便	pmjb
谝	pmsi
翩	pmmz
楩	pmeb
扁	pmmi
胼	pmvl
蹁	pmpi
犏	pmqi
㛹	pmbb
𡎚	pmgi
票	pnvf
飘	pnvb
漂	pnkf
嫖	pnbf
瞟	pnqf
瓢	pnvy
剽	pnvp
缥	pnif
骠	pnnf
朴	pney
殍	pngh
薸	pnlf
嘌	pndf
蔈	pnlf
螵	pncf
撇	ppuh
瞥	ppfq
氕	ppvt
苤	pplf
𬭯	ppzh
拼	pbul
品	pbdd
频	pbsw
贫	pbho
聘	pbqa
嫔	pbbh
颦	pbsn
牝	pbqv
姘	pbbl
玭	pbnv
𬞟	pblw
屏	pkcl
平	pkeh
凭	pkjo
瓶	pkhr
评	pksh
坪	pkgh
萍	pklh
枰	pkeh
乒	pktt
苹	pklh
娉	pkba
鲆	pkwh
俜	pkja
冯	pkwn
洴	pkkl
泙	pkkh
玶	pknh
涄	pkka
帡	pkrl
荓	pkll
蚲	pkch
破	pomr
颇	porw
坡	pogr
泼	poki
婆	pokb
迫	pouu
珀	ponu
钋	pozy
魄	poua
钷	pozd
泊	poku
粕	popu
鄱	pott
皤	pouq
叵	pond
酦	poyi
陂	potr
桲	poeh
朴	poey
繁	poei
笸	pord
䥽	pozi
剖	pzip
裒	pztp
掊	pzud
抔	pzuc
谱	puso
铺	puzn
普	puho
扑	puuy
噗	pudi
朴	puey
葡	puln
蒲	puln
璞	puni
仆	pujy
浦	pukn
濮	puki
莆	puln
溥	pukk
瀑	pukk
圃	purn
蹼	pupi
曝	puok
埔	pugn
镤	puzi
堡	pujg
镨	puzo
菩	puld
酺	puyn
匍	punn
蒱	puln
潽	puko
脯	puvn
墣	pugi
氆	puvo
穙	puxi
其	qizh
起	qipv
期	qizv
七	qirq
气	qivq
器	qidd
骑	qinz
齐	qiqq
棋	qieh
漆	qikk
奇	qimz
弃	qibl
旗	qilh
妻	qifb
绮	qiiz
欺	qize
岂	qivv
琪	qinh
砌	qimp
启	qimd
企	qijs
契	qiam
淇	qikh
泣	qiki
琦	qinz
栖	qiev
鳍	qiwo
乞	qiea
祁	qift
戚	qiny
祇	qifb
麒	qixh
炁	qidc
汽	qikv
沏	qikp
柒	qike
祈	qift
祺	qifh
讫	qisa
脐	qivq
崎	qivz
岐	qivc
蕲	qilt
迄	qieu
杞	qiev
萁	qilh
嘁	qidy
欹	qime
锜	qizz
凄	qiwb
槭	qiey
碛	qimo
畦	qiqg
綦	qizi
歧	qisc
玘	qinv
亓	qimp
耆	qiqo
芑	qilv
屺	qivv
埼	qigz
憩	qiah
跂	qipc
芪	qilb
棨	qime
葺	qilq
蹊	qipm
颀	qitw
骐	qinh
汔	qika
圻	qigt
磜	qimf
萋	qilb
蜞	qich
蛴	qicq
亟	qirf
愭	qiho
桤	qiev
俟	qijo
荠	qilq
婍	qibz
郪	qift
稽	qixo
缉	qiiq
洓	qikm
鲯	qiwh
碶	qimm
䓫	qilz
𨙸	qict
𬨂	qiyb
掐	qxup
恰	qxhd
卡	qxyy
髂	qxfs
洽	qxkd
袷	qxtd
拤	qxuy
葜	qxlm
前	qmhp
钱	qmzp
千	qmlq
签	qmrf
浅	qmkp
欠	qmeq
铅	qmzd
牵	qmmq
遣	qmcu
潜	qmko
迁	qmlu
乾	qmna
谦	qmsc
嵌	qmve
钳	qmzz
黔	qmpa
茜	qmlv
钤	qmza
芡	qmle
歉	qmhe
虔	qmzv
芊	qmll
倩	qmjv
骞	qmwn
仟	qmjl
堑	qmyg
搴	qmwu
阡	qmtl
谴	qmsu
汧	qmkl
靬	qmte
荨	qmlk
愆	qmph
佥	qmjf
椠	qmye
扦	qmul
褰	qmwt
犍	qmqu
缱	qmiu
慊	qmhc
悭	qmhg
钎	qmzl
杄	qmel
鹐	qmxx
蒨	qmlv
岍	qmvl
磏	qmmc
纤	qmil
掮	qmuv
墘	qmga
肷	qmve
圲	qmgl
伣	qmje
𬘬	qmiv
强	qlbc
抢	qluz
枪	qlez
墙	qlgd
腔	qlvu
呛	qldz
羌	qlga
蔷	qlld
炝	qlcz
羟	qlgu
锵	qlzk
戗	qljp
戕	qlap
锖	qlzv
樯	qled
玱	qlnz
镪	qlzc
蜣	qlca
嫱	qlbd
襁	qltc
跄	qlpz
蔃	qllc
敲	qngh
桥	qnep
乔	qntp
翘	qnpz
瞧	qnqc
巧	qnua
撬	qnuv
壳	qngo
鞘	qntv
俏	qnjv
樵	qnec
窍	qnea
谯	qnsc
锹	qnzc
侨	qnjp
悄	qnhv
跷	qnpp
荞	qnlp
诮	qnsv
橇	qnev
峤	qnvp
劁	qnup
峭	qnvv
缲	qnie
硚	qnmp
鞒	qntp
雀	qnyu
憔	qnhc
愀	qnhc
硗	qnmp
且	qpfq
切	qprp
妾	qpib
窃	qpep
怯	qphk
茄	qpld
箧	qprh
挈	qpau
伽	qpjd
锲	qpzm
惬	qphh
郄	qpbt
慊	qphc
趄	qppf
琴	qbna
秦	qbax
亲	qbie
勤	qbls
寝	qbwr
擒	qbuv
钦	qbze
沁	qbkh
侵	qbjr
禽	qbjv
衾	qbjt
噙	qbdv
芹	qblt
骎	qbnr
溱	qbkx
覃	qbvn
嗪	qbdx
芩	qbla
揿	qbue
梣	qbea
慬	qbha
嵚	qbve
螓	qbcx
锓	qbzr
檎	qbev
吣	qbdh
请	qksv
轻	qkyu
清	qkkv
氢	qkvu
情	qkhv
青	qkav
晴	qkov
卿	qkbi
倾	qkjw
庆	qkxm
黥	qkpy
磬	qkgm
顷	qkvw
擎	qklu
箐	qkrv
氰	qkvv
罄	qkga
蜻	qkcv
鲭	qkwv
綮	qkmi
檠	qkle
亲	qkie
圊	qkrv
勍	qkgs
碃	qkmv
庼	qkxw
倩	qkjv
苘	qkld
穷	qses
琼	qsny
蛩	qsuc
邛	qsut
穹	qseb
茕	qsln
銎	qsuz
筇	qsrt
䓖	qsls
球	qqni
求	qqfi
秋	qqxc
邱	qqtt
丘	qqtf
裘	qqft
糗	qqpm
楸	qqec
囚	qqrj
逑	qqfu
湫	qqkc
虬	qqca
璆	qqne
酋	qqhy
仇	qqjk
萩	qqlc
遒	qqhu
鳅	qqwc
泅	qqkj
俅	qqji
鼽	qqok
赇	qqoi
龟	qqwg
蚯	qqcf
蝤	qqcy
鹙	qqxx
訄	qqks
犰	qqmk
巯	qqro
鞧	qqty
𨱇	qqzi
去	qugk
区	qunb
取	quqr
曲	quyq
娶	quqb
屈	qucm
趣	qupr
蛆	qucf
龋	qulv
驱	qunb
瞿	ququ
祛	qufk
渠	quke
趋	qupb
躯	quzb
鼩	qupg
觑	quze
诎	qusm
麹	quap
衢	qupu
蕖	qule
蘧	qulu
袪	qutk
胠	quvk
朐	quvg
劬	qugs
阒	quam
苣	quln
璩	qunj
癯	quau
鸲	qugx
戌	qunf
焌	quch
蠼	qucr
氍	quqv
黢	quph
岨	quvf
坥	qugf
灈	quku
岖	quvb
蛐	qucy
磲	qume
竘	quig
㭕	quek
䓛	qulm
𪨰	quvy
𫭟	qugb
全	qrjn
圈	qrrz
权	qrer
劝	qrrs
券	qrhp
拳	qrhu
犬	qrmq
泉	qruk
醛	qryn
蜷	qrcz
荃	qrln
颧	qrlw
诠	qrsn
佺	qrjn
铨	qrzn
鬈	qrpz
痊	qran
绻	qriz
筌	qrrn
畎	qrqm
悛	qrhh
辁	qryn
棬	qrez
瑔	qrnk
鳈	qrwk
婘	qrbz
𨟠	qrqt
却	qtgz
缺	qtaj
确	qtmt
卻	qthz
阙	qtae
雀	qtyu
瘸	qtaj
鹊	qtlx
榷	qteu
炔	qtcj
阕	qtam
悫	qtgh
碏	qtmo
埆	qtgt
𬒈	qtkm
群	qybg
裙	qytd
囷	qyrx
麇	qyxx
逡	qyku
然	rjvc
燃	rjcc
染	rjke
冉	rjmg
髯	rjpg
蚺	rjcg
苒	rjlg
䎃	rjmz
让	rhsf
穰	rhxf
嚷	rhdf
瓤	rhty
攘	rhuf
禳	rhff
壤	rhgf
瀼	rhkf
儴	rhjf
蘘	rhlf
绕	rcip
饶	rcqp
扰	rcuo
桡	rcep
娆	rcbp
荛	rclp
热	reuc
惹	relh
人	rfjr
任	rfjg
认	rfsj
忍	rfph
仁	rfjm
刃	rfpi
壬	rftg
韧	rfgi
饪	rfqg
稔	rfxh
妊	rfbg
衽	rftg
纫	rfii
仞	rfji
轫	rfyi
讱	rfsi
纴	rfig
葚	rfla
荏	rflg
仍	rgjv
扔	rguv
日	rior
驲	rino
融	rsnc
容	rswh
蓉	rslh
荣	rsle
溶	rskh
戎	rspn
绒	rsin
熔	rsch
冗	rswo
茸	rslq
榕	rseh
镕	rszh
嵘	rsve
狨	rsmn
瑢	rsnh
蝾	rsce
肉	rzmj
揉	rzue
柔	rzie
鞣	rzte
糅	rzpe
蹂	rzpe
𫐓	rzye
如	rubd
入	ruju
乳	ruya
汝	rukb
儒	rujl
辱	rufk
濡	rukl
茹	ruld
铷	ruzd
褥	rutk
襦	rutl
蓐	rulk
孺	ruhl
洳	rukd
蠕	rucl
溽	rukk
缛	ruik
嬬	rubl
嚅	rudl
薷	rull
颥	rutw
挼	rxub
软	rrye
阮	rrtp
堧	rrgm
瓀	rrnl
媆	rrbm
瑞	rvnl
睿	rvgq
锐	rvzp
蕊	rvlh
芮	rvlj
汭	rvkj
蚋	rvcj
蕤	rvll
枘	rvej
润	rykn
闰	ryan
若	rold
弱	robw
箬	rord
偌	rojd
爇	rolc
蒻	rolw
鄀	rolt
婼	robd
撒	sauh
萨	salx
仨	sajt
洒	sakv
飒	saib
卅	sals
靸	satc
潵	sakh
挲	saku
脎	save
赛	sdwo
塞	sdwg
鳃	sdwh
腮	sdvh
噻	sddg
三	sjts
散	sjlh
伞	sjjn
叁	sjkt
糁	sjpe
毵	sjkv
馓	sjqh
桑	shre
嗓	shde
丧	shgt
颡	shrw
搡	shue
磉	shme
扫	scub
骚	scnc
嫂	scbr
搔	scuc
臊	scve
埽	scgr
缫	scie
瘙	scac
溞	sckc
色	sexm
瑟	sent
涩	seks
铯	sezm
塞	sewg
啬	segd
穑	sexd
璱	sent
森	sfee
僧	sgjo
啥	uada
杀	uabe
傻	uajh
沙	uakt
鲨	uakw
莎	ualt
煞	uaxc
纱	uait
砂	uamt
刹	uabp
痧	uaat
厦	uaxh
嗄	uadh
歃	uale
霎	uatb
铩	uaze
裟	uakt
唼	uadb
杉	uaee
挲	uaku
晒	udov
筛	udrr
色	udxm
山	ujvs
删	ujip
闪	ujaj
善	ujgd
扇	ujmz
衫	ujte
擅	ujuf
陕	ujth
珊	ujni
膳	ujvd
杉	ujee
煽	ujcz
膻	ujvf
疝	ujav
骟	ujnz
钐	ujze
赡	ujos
讪	ujsv
禅	ujfn
剡	ujcp
缮	ujid
鳝	ujwd
苫	ujld
鄯	ujgt
芟	ujlr
嬗	ujbf
埏	ujgu
汕	ujkv
晱	ujoc
姗	ujbi
潸	ujkv
跚	ujpi
烻	ujcu
蟮	ujcd
单	ujhn
栅	ujei
舢	ujiv
墡	ujgd
嶦	ujvs
𫮃	ujgn
上	uhyf
商	uhid
伤	uhjs
熵	uhcd
尚	uhss
赏	uhso
殇	uhge
裳	uhst
觞	uhxe
墒	uhgd
垧	uhgd
晌	uhod
绱	uhis
少	ucyt
烧	uccp
稍	ucxv
勺	ucni
捎	ucuv
哨	ucdv
邵	ucpt
绍	ucid
梢	ucev
苕	ucld
韶	ucxd
蛸	uccv
劭	ucps
潲	uckv
艄	uciv
芍	ucli
筲	ucrv
召	ucpd
鞘	uctv
睄	ucqv
柖	uced
玿	ucnd
社	uefg
蛇	uecv
设	uesr
射	uezk
舍	ueja
舌	ueas
摄	ueur
涉	ueks
折	ueut
赦	uegh
奢	uemo
赊	ueof
佘	uejf
麝	uexk
慑	uehr
歙	ueje
畲	uejq
阇	ueao
滠	uekr
厍	uexy
拾	ueud
猞	uema
𪨶	uevy
谁	uwsu
神	uffg
深	ufke
身	ufzs
申	ufog
肾	ufpv
沈	ufkp
甚	ufza
审	ufwg
伸	ufjg
什	ufjn
砷	ufmg
慎	ufhh
婶	ufbg
渗	ufke
侁	ufjp
糁	ufpe
哂	ufdv
蜃	uffc
莘	ufln
诜	ufsp
瘆	ufae
甡	ufll
参	ufke
燊	ufce
谌	ufsa
椹	ufea
矧	ufog
绅	ufig
呻	ufdg
屾	ufvv
珅	ufng
谂	ufsh
胂	ufvg
葚	ufla
鲹	ufwe
娠	ufbf
棽	ufea
瞫	ufqn
𬬹	ufzg
𬳽	ufnp
生	ugls
声	uggc
省	ugyq
升	ugtl
胜	ugvl
圣	ugrg
剩	ugxp
绳	ugid
笙	ugrl
昇	ugol
盛	ugna
晟	ugoa
牲	ugql
甥	ugls
陞	ugtg
眚	uglq
乘	ugxv
嵊	ugvv
是	uiot
时	uiok
式	uipu
使	uijb
事	uifb
师	uipr
史	uidb
诗	uisk
市	uizr
屎	uicp
十	uins
视	uife
室	uiwy
石	uims
试	uisu
实	uiwm
饰	uiqr
士	uigs
湿	uikc
食	uiqs
氏	uibs
势	uius
世	uila
施	uile
失	uith
始	uibd
尸	uics
识	uish
狮	uimr
适	uiau
矢	uios
嗜	uido
谥	uisa
誓	uius
拾	uiud
弑	uibu
释	uitu
示	uifs
恃	uihk
侍	uijk
仕	uijg
逝	uiuu
豕	uijs
轼	uiyu
蚀	uiqc
噬	uidj
匙	uiov
虱	uiac
拭	uiuu
祏	uifm
铈	uizr
柿	uier
奭	uimu
莳	uilk
驶	uinb
似	uijj
舐	uiab
筮	uirj
湜	uikt
栻	uieu
螫	uigc
贳	uilo
蓍	uilo
炻	uicm
什	uijn
酾	uiyv
鲥	uiwk
媞	uibt
鼫	uipm
鸤	uicx
嘘	uidc
鲺	uiwc
殖	uigf
峙	uivk
襫	uitu
邿	uigt
浉	uikr
埘	uigk
䏡	uivf
䴓	uifx
𫚕	uiwr
𬤊	uist
受	uzyr
手	uzus
收	uzih
首	uzho
瘦	uzar
守	uzwk
兽	uzhd
寿	uzak
售	uzud
授	uzur
熟	uzgc
绶	uzir
艏	uzio
狩	uzmk
书	uuai
数	uuph
树	uuek
属	uucv
输	uuyp
术	uuei
叔	uuyr
熟	uugc
蜀	uuyc
竖	uupi
鼠	uups
疏	uuto
舒	uuji
梳	uueo
赎	uuom
束	uuxs
孰	uugi
述	uueu
署	uuyo
黍	uuxk
塾	uugg
姝	uuba
恕	uubh
淑	uukr
庶	uuxc
戍	uuni
漱	uuke
殊	uuga
暑	uuoo
殳	uurs
薯	uulo
曙	uuoo
抒	uuui
蔬	uulo
枢	uueb
菽	uulr
澍	uukk
倏	uujm
墅	uudg
腧	uuvp
摅	uuuh
纾	uuii
隃	uutp
秫	uuxi
沭	uuki
婌	uubr
陎	uuta
毹	uujv
鄃	uujt
𬬸	uuzi
刷	uxcp
耍	uxlb
唰	uxdp
帅	ukpr
甩	ukta
摔	ukun
衰	uktf
率	ukzn
蟀	ukcn
涮	urkp
栓	uren
拴	urun
闩	uraf
腨	urvl
双	ulrr
爽	ulmb
霜	ultq
泷	ulkt
孀	ulbq
鹴	ultx
骦	ulnq
漴	ulkf
礵	ulmq
水	uvks
谁	uvsu
睡	uvqg
税	uvxp
帨	uvrp
说	uvsp
顺	uyow
舜	uyyv
瞬	uyqv
吮	uydp
楯	uyeq
说	uosp
硕	uomw
朔	uohv
槊	uohe
烁	uocy
搠	uouv
铄	uozy
数	uoph
妁	uobi
蒴	uolv
四	siys
死	sigv
斯	sizt
撕	siut
丝	siii
似	sijj
寺	sigk
思	siqh
私	sixk
司	siad
饲	siqd
嗣	sidd
巳	sivs
嘶	sidt
肆	sipb
祀	sifv
驷	siny
姒	sibj
俟	sijo
锶	sizh
泗	siky
厮	sixt
兕	simp
笥	sird
汜	sikv
咝	sidi
伺	sijd
鸶	siix
涘	siko
缌	siih
耜	siak
澌	sikt
蛳	sicr
虒	sixz
飔	sioh
凘	siwt
㟃	sivd
楒	sieh
送	sshu
宋	sswe
怂	ssjh
松	ssek
颂	sshw
诵	ssst
菘	sslk
崧	ssvk
耸	ssjq
嵩	ssvg
竦	ssix
淞	sskk
讼	sssk
娀	ssbn
凇	sswk
悚	sshx
𪨊	sscj
忪	sshk
㧐	ssur
搜	szur
艘	szir
嗖	szdr
馊	szqr
叟	szpr
廋	szxr
薮	szlh
溲	szkr
瞍	szqr
嗽	szde
蒐	szla
飕	szor
嗾	szdo
擞	szuh
锼	szzr
螋	szcr
苏	sulh
酥	suyx
素	suai
速	suxu
俗	sujh
诉	susi
宿	suwu
粟	suvp
溯	sukv
塑	suhg
肃	subh
稣	suwx
谡	sush
愫	suhi
夙	suog
甦	sufl
涑	sukx
窣	suen
骕	sunh
蔌	sule
嗉	sudi
簌	sure
傃	suji
鹔	subx
蹜	supu
缩	suiu
僳	sujp
觫	suxx
𫗧	suqx
算	srrl
酸	sryh
蒜	srlf
狻	srmh
岁	svvl
随	svtu
虽	svdc
遂	svhu
碎	svmn
隋	svtv
穗	svxh
髓	svfu
燧	svcu
尿	svck
隧	svtu
睢	svqu
绥	svib
祟	svsf
荽	svlb
谇	svsn
眭	svqg
邃	sveu
濉	svku
旞	svlu
穟	svxu
璲	svnu
襚	svtu
𫟦	svyu
𬭼	svzu
孙	syhy
损	syuo
隼	syun
榫	syen
笋	syrt
飧	sylq
荪	syly
狲	symy
所	somt
锁	sozo
索	soni
缩	soiu
嗦	sodi
梭	soeh
娑	sokb
蓑	solf
唆	sodh
琐	sono
羧	sogh
睃	soqh
溹	soki
葰	solh
唢	sodo
嗍	sodv
莎	solt
挲	soku
桫	soet
他	taje
它	tawv
她	tabe
塔	tagd
塌	tagz
踏	tapo
祂	tafe
挞	tauu
拓	taum
铊	tazv
榻	taez
牠	taqe
趿	tapc
沓	tako
獭	tamo
闼	taau
蹋	tapz
鳎	tawz
溻	takz
遢	taou
鞳	tatd
阘	taaz
褟	tatz
鿎	tamu
太	tdmi
台	tdkd
态	tdmh
胎	tdvd
抬	tdud
泰	tdak
钛	tdzi
肽	tdvi
苔	tdld
汰	tdki
鲐	tdwd
骀	tdnd
邰	tdkt
薹	tdly
酞	tdyi
跆	tdpd
炱	tdkc
谈	tjsc
碳	tjmc
弹	tjbn
摊	tjuu
贪	tjjo
痰	tjac
探	tjue
谭	tjsn
叹	tjdr
滩	tjku
坛	tjgb
坦	tjgf
炭	tjvc
瘫	tjau
檀	tjef
毯	tjvc
潭	tjkn
昙	tjob
钽	tjzf
覃	tjvn
郯	tjct
坍	tjgz
璮	tjnf
镡	tjzn
惔	tjhc
忐	tjyh
菼	tjlc
袒	tjtf
倓	tjjc
澹	tjks
锬	tjzc
榃	tjeq
磹	tjmn
糖	thpd
汤	thke
唐	thxd
躺	thzs
烫	thkc
堂	thsg
趟	thps
棠	thse
淌	thks
塘	thgd
倘	thjs
膛	thvg
蹚	thpg
帑	thbr
樘	theg
镗	thzg
傥	thjp
溏	thkd
螳	thcg
镋	thzp
搪	thud
羰	thgc
嘡	thdg
螗	thcd
瑭	thnd
鄌	thxt
耥	thas
埫	thgs
铴	thze
䣘	thst
套	tcmp
淘	tcka
逃	tcpu
掏	tcua
讨	tcsk
桃	tcew
陶	tcta
韬	tcgp
涛	tckk
弢	tcbr
饕	tcdq
绦	tcie
洮	tckw
叨	tcdp
滔	tckp
萄	tcla
焘	tcac
梼	tcek
绹	tcia
啕	tcda
慆	tchp
鼗	tcpc
𫘦	tcna
特	teqk
铽	tezh
慝	tenh
忒	teph
忑	tefh
忒	twph
疼	tgaw
藤	tglk
腾	tgvn
滕	tgvk
熥	tgcu
誊	tghs
縢	tgvi
螣	tgvc
䲢	tgvw
题	tiow
提	tiut
体	tijf
踢	tipe
替	tiho
剃	tihp
梯	tiet
缇	tiit
锑	tizt
蹄	tipr
剔	tiop
啼	tidr
悌	tiht
涕	tikt
惕	tihe
薙	tilu
醍	tiyt
屉	tica
嚏	tidt
鹈	tihx
擿	tiuu
绨	tiit
荑	tilb
倜	tijd
裼	tite
媞	tibt
鳀	tiwt
逖	timu
趯	tipu
瑅	tint
遆	tiiu
䏲	tivt
䴘	tixx
𫘨	tint
天	tmfm
甜	tmaz
填	tmgh
田	tmqt
舔	tmah
添	tmkh
忝	tmfh
湉	tmka
殄	tmge
恬	tmha
腆	tmvh
阗	tmah
掭	tmuh
觍	tmie
瑱	tmnh
沺	tmkq
畋	tmqh
淟	tmkh
晪	tmoh
盷	tmqw
黇	tmnd
条	tnhe
跳	tnpw
挑	tnuw
调	tnsd
祧	tnfw
窕	tnew
朓	tnvw
粜	tnsp
蜩	tncd
佻	tnjw
眺	tnqw
苕	tnld
嬥	tnbu
鲦	tnwe
髫	tnpd
迢	tnpu
笤	tnrd
龆	tnld
贴	tpod
铁	tpzh
帖	tprd
餮	tpgq
萜	tpld
听	tkdt
挺	tkuu
停	tkja
厅	tkxa
亭	tkga
艇	tkiu
庭	tkxu
汀	tkka
廷	tktu
婷	tkba
霆	tktu
烃	tkcu
铤	tkzu
珽	tknu
梃	tkeu
渟	tkka
葶	tkla
蜓	tkcu
莛	tklu
圢	tkga
桯	tken
颋	tktw
侹	tkju
烶	tkcu
䗴	tkcu
𬘩	tkiu
同	tsmd
通	tsku
痛	tsat
铜	tszd
桶	tset
捅	tsut
筒	tsrd
佟	tsjw
统	tsip
童	tsid
酮	tsyd
瞳	tsqd
桐	tsed
彤	tsme
砼	tsmu
嗵	tsdu
僮	tsjd
恸	tshs
仝	tsju
穜	tsxd
潼	tskd
烔	tscd
橦	tsed
垌	tsgd
茼	tsld
洞	tskd
峒	tsvd
曈	tsod
哃	tsdd
鲖	tswd
㛚	tsbt
峂	tsvw
𦒍	tsiz
𫍣	tssd
头	tzwm
投	tzur
偷	tzjp
透	tzxu
骰	tzfr
图	turw
土	tugt
吐	tudg
涂	tukx
兔	tuwt
突	tuem
屠	tuco
徒	tuwp
凸	tuvf
秃	tuxo
途	tuju
荼	tulx
钍	tuzg
酴	tuyx
菟	tulw
凃	tuwx
稌	tuxx
堍	tugw
腯	tuvq
梌	tuex
葖	tulm
㻬	tuna
𬳿	tunx
团	trrt
彖	trbj
湍	trkl
抟	trui
猯	trml
疃	trqd
煓	trcl
推	tvuu
腿	tvvu
退	tviu
忒	tvph
颓	tvxw
褪	tvtu
蜕	tvcp
煺	tvcu
魋	tvau
𬯎	tvto
囤	tyrs
臀	tycv
吞	tyfd
屯	tyfs
豚	tyvj
鲀	tyws
暾	tyoh
焞	tych
饨	tyqs
坉	tygs
褪	tytu
忳	tyhs
拖	toue
托	tour
脱	tovp
坨	togv
陀	totv
驼	tonv
驮	tonm
拓	toum
妥	toyb
佗	tojv
侂	tojr
唾	todg
沱	tokv
铊	tozv
橐	tone
鼍	todd
鸵	toxv
椭	toev
砣	tomv
柁	toev
箨	toru
跎	topv
酡	toyv
柝	toei
圫	togr
萚	tolu
庹	toxi
𬶍	towv
哇	wadg
挖	waua
娃	wabg
瓦	warw
蛙	wacg
袜	wate
洼	wakg
娲	wabj
凹	wamf
佤	wajr
窊	waey
坬	wagy
腽	wava
畖	waqy
外	wdly
歪	wdcs
崴	wdvb
万	wjfp
玩	wjnp
完	wjwp
晚	wjop
碗	wjmz
弯	wjzb
丸	wjki
湾	wjkb
挽	wjup
绾	wjik
腕	wjvz
纨	wjii
烷	wjcp
剜	wjwp
皖	wjup
菀	wjlz
卍	wjaa
宛	wjwz
顽	wjmw
豌	wjzz
婉	wjbz
莞	wjlp
畹	wjqz
脘	wjvp
椀	wjez
婠	wjbk
琬	wjnz
惋	wjhz
蜿	wjcz
芄	wjli
蔓	wjlr
塆	wjgb
𬇕	wjkp
往	whwn
王	whnw
网	whmb
望	whfn
忘	whfh
汪	whkn
亡	whfw
旺	whon
妄	whfb
枉	when
罔	whmf
辋	whyf
尢	whoy
惘	whhf
魍	whaf
尪	whon
为	wwii
位	wwji
未	wwaw
味	wwda
微	wwwh
喂	wwdt
伪	wwji
胃	wwqv
维	wwiu
威	wwnb
唯	wwdu
魏	wwxa
尾	wwcv
卫	wwzf
谓	wwsv
围	wwrg
韦	wwgw
惟	wwhu
委	wwxb
危	wwxz
薇	wwlh
畏	wwqt
煨	wwct
伟	wwjg
隈	wwtt
炜	wwcg
违	wwgu
尉	wwck
苇	wwlg
萎	wwlb
慰	wwch
纬	wwig
鲔	wwwv
蔚	wwlk
圩	wwgn
艉	wwiv
玮	wwng
帷	wwru
渭	wwkv
帏	wwrg
洧	wwkv
桅	wwez
猥	wwmt
痿	wwab
巍	wwva
嵬	wwva
猬	wwmv
薳	wwlu
鳚	wwwk
潍	wwku
亹	wwzf
葳	wwlb
偎	wwjt
闱	wwag
诿	wwsb
韪	wwog
娓	wwbv
隗	wwta
溦	wwkh
沩	wwki
硙	wwmv
崴	wwvb
煟	wwcv
廆	wwxa
逶	wwxu
碨	wwmt
涠	wwkg
洈	wwkz
霨	wwtk
琟	wwnu
峗	wwvz
螱	wwcc
鳂	wwwt
𣲗	wwkg
𫇭	wwli
𬀩	wwog
𬱟	wwxw
𬶏	wwwz
问	wfad
文	wfvw
稳	wfxh
闻	wfaq
纹	wfiv
温	wfka
吻	wfde
蚊	wfcv
瘟	wfaa
玟	wfnv
雯	wftv
汶	wfkv
炆	wfcv
辒	wfya
刎	wfnp
阌	wfar
紊	wfvi
蕰	wfla
榅	wfea
芠	wflv
鳁	wfwa
璺	wfpi
𫘜	wfnv
翁	wghz
嗡	wgdz
瓮	wghr
滃	wgkz
蓊	wglz
蕹	wglu
鹟	wghx
𬭩	wgzz
我	wotp
喔	wody
窝	woej
握	wouy
沃	wokm
卧	woqy
涡	wokj
倭	wojb
斡	wonj
龌	woly
渥	woky
偓	wojy
蜗	wocj
挝	wouu
肟	wova
幄	wory
硪	womp
涴	wokz
莴	wolj
踒	wopb
无	wudu
五	wuwu
物	wuqe
吴	wudm
吾	wuwd
勿	wune
乌	wuxu
舞	wuev
武	wufs
屋	wucy
误	wusm
悟	wuhd
唔	wudd
雾	wuts
捂	wuud
伍	wujw
戊	wunu
污	wuka
呜	wudx
午	wuen
务	wuhs
巫	wuuj
兀	wufp
钨	wuzx
坞	wugx
恶	wufh
毋	wuku
邬	wuxt
诬	wusj
寤	wuwd
庑	wuxd
侮	wujk
焐	wucd
芜	wuld
旿	wuon
忤	wuhn
鹜	wuix
梧	wued
晤	wuod
骛	wuin
杌	wuep
迕	wueu
鹀	wuux
鼯	wupd
圬	wuga
妩	wubd
怃	wuhd
洿	wuka
浯	wukd
珷	wuns
芴	wule
婺	wuib
鋈	wukz
屼	wuvp
鹉	wufx
铻	wuzd
珸	wund
蜈	wucm
牾	wuqd
郚	wuwt
仵	wujn
痦	wuad
靰	wutp
峿	wuvd
𣲘	wukd
系	xiti
洗	xikp
戏	xirp
西	xivx
细	xiiq
吸	xidc
喜	xihd
兮	xiha
希	xibr
席	xixr
膝	xivk
稀	xixr
锡	xize
习	xizx
奚	xiym
息	xioh
昔	xilo
硒	ximv
惜	xiho
袭	xitt
溪	xikm
悉	xith
徙	xiws
曦	xiop
析	xiet
玺	xixi
熄	xich
隙	xity
夕	xilx
汐	xikl
蜥	xict
熙	xiqc
茜	xilv
嘻	xidd
檄	xieh
铣	xizp
晞	xior
晰	xiot
犀	xicq
禧	xifd
嬉	xibd
豨	xijr
烯	xicr
釐	xiad
隰	xitc
羲	xigp
郤	xiht
谿	xiyh
郗	xibt
牺	xiqv
歙	xije
僖	xijd
熹	xihc
咥	xidy
禊	xifm
翕	xijz
觋	xiue
皙	xieu
媳	xibh
枲	xike
嶲	xivm
饩	xiqv
醯	xiya
憙	xihh
唏	xidr
舄	xipc
浠	xikr
舾	xiiv
淅	xikt
蹊	xipm
傒	xijm
螅	xich
肸	xivn
屣	xics
觿	xixd
酅	xivt
穸	xiel
屃	xico
蓰	xils
潟	xikc
鳛	xiwu
裼	xite
鼷	xipm
阋	xiap
绤	xiih
蟋	xich
葸	xilh
樨	xieq
爔	xicp
睎	xiqr
熻	xicz
粞	xipv
巇	xivp
窸	xieh
俙	xijr
菥	xilt
恓	xihv
嶍	xivu
暿	xiod
饻	xiqt
𠅤	xizh
𫘬	xinm
𬭳	xizd
𬶮	xiwd
下	xxfy
瞎	xxqd
夏	xxfh
侠	xxjh
虾	xxcy
吓	xxdy
霞	xxtr
峡	xxvh
瑕	xxnr
狭	xxmh
匣	xxns
辖	xxyd
呷	xxds
叚	xxcr
暇	xxor
狎	xxms
遐	xxcu
硖	xxmh
罅	xxan
柙	xxes
黠	xxpd
厦	xxxh
翈	xxsz
先	xmqp
线	xmip
险	xmtf
弦	xmbi
现	xmne
县	xmfk
嫌	xmbc
仙	xmjv
咸	xmnd
显	xmoc
鲜	xmwg
限	xmti
闲	xmae
藓	xmlg
馅	xmqp
献	xmnm
贤	xmpo
掀	xmue
陷	xmtp
衔	xmpz
见	xmej
酰	xmyp
氙	xmvv
腺	xmvk
娴	xmbe
羡	xmge
霰	xmth
筅	xmrp
纤	xmil
宪	xmwp
籼	xmpv
蚬	xmce
冼	xmwp
舷	xmii
涎	xmku
岘	xmve
苋	xmle
狝	xmmy
跣	xmpp
燹	xmjc
锨	xmze
洗	xmkp
祆	xmfm
暹	xmou
缐	xmik
猃	xmmf
痫	xmae
伭	xmji
崄	xmvf
跹	xmpu
莶	xmlf
挦	xmuk
孅	xmbf
忺	xmhe
鹇	xmax
禒	xmfj
㬎	xmoc
𪾢	xmqe
𫍯	xmsd
𬀪	xmoe
𬸣	xmwx
想	xleh
像	xljw
向	xltd
项	xluw
香	xlxo
相	xleq
象	xlwx
箱	xlrq
乡	xlix
响	xldd
降	xltv
翔	xlgz
橡	xlew
巷	xllv
享	xlgh
湘	xlkq
厢	xlxq
镶	xlzf
祥	xlfg
饷	xlqd
飨	xliq
详	xlsg
襄	xltf
芗	xlli
庠	xlxg
骧	xlnf
缃	xliq
瓖	xlnf
鲞	xlhw
珦	xlnd
葙	xllq
𬙋	xlif
小	xnyx
笑	xnrm
肖	xnyv
校	xneb
箫	xnrh
孝	xnqh
逍	xnyu
萧	xnlh
消	xnkv
削	xnyp
晓	xnop
效	xnah
销	xnzv
枭	xnxe
筱	xnrh
鸮	xndx
骁	xnnp
咲	xndm
宵	xnwv
魈	xnav
硝	xnmv
崤	xnvv
枵	xnea
啸	xndh
绡	xniv
霄	xntv
潇	xnkh
蛸	xncv
嚣	xndd
虓	xnkz
翛	xnjz
猇	xnmz
淆	xnkv
皛	xnuu
哮	xndh
洨	xnkb
哓	xndp
涍	xnkh
滧	xnkh
蟏	xnch
敩	xnkh
𫍲	xnsr
写	xpwf
些	xpsm
鞋	xptg
血	xpta
谢	xpsk
斜	xpjj
蟹	xpxc
邪	xplt
携	xpuv
卸	xpaz
歇	xpoe
屑	xpcv
挟	xpuh
协	xpnh
泻	xpkf
泄	xpka
蝎	xpcf
械	xpel
偕	xpju
燮	xpsr
谐	xpsu
胁	xpvh
解	xpxq
榭	xpek
楔	xpem
薤	xplf
澥	xpkq
亵	xpti
缬	xpiw
懈	xphq
绁	xpia
撷	xpuw
絜	xpai
廨	xpxq
獬	xpmq
渫	xpke
勰	xpsh
偰	xpjm
瀣	xpkf
颉	xpgw
邂	xpxu
揳	xpum
叶	xpdn
薢	xplq
躞	xppr
榍	xpev
㙦	xpjg
𤫉	xpnr
𬹼	xplp
新	xbit
心	xbhx
信	xbjs
芯	xblh
锌	xbzn
辛	xbnx
薪	xblt
欣	xbte
鑫	xbzz
馨	xbgo
昕	xbot
忻	xbht
歆	xbxe
衅	xbtu
炘	xbct
镡	xbzn
囟	xbtb
伈	xbjh
莘	xbln
䜣	xbst
𫷷	xbxe
型	xkfg
性	xkhl
星	xkol
行	xkpx
形	xkfe
姓	xkbl
醒	xkyl
兴	xkkh
邢	xkft
刑	xkfp
幸	xkgg
杏	xked
腥	xkvl
陉	xktu
擤	xkul
荇	xklp
省	xkyq
饧	xkqe
猩	xkml
煋	xkcl
骍	xknn
婞	xkbg
惺	xkhl
荥	xklk
铏	xkzp
悻	xkhg
钘	xkzl
瑆	xknl
硎	xkmp
𫰛	xkbu
胸	xsvm
熊	xskc
凶	xsbm
兄	xsdp
雄	xsnu
匈	xsnm
芎	xslb
夐	xsxh
讻	xssm
汹	xskm
诇	xssd
修	xqje
秀	xqxv
休	xqje
绣	xqiv
嗅	xqdm
溴	xqkm
锈	xqzv
羞	xqgg
袖	xqtd
咻	xqde
脩	xqjv
岫	xqvd
朽	xqea
髹	xqpe
宿	xqwu
琇	xqnv
貅	xqme
庥	xqxe
滫	xqkv
臭	xqom
珛	xqnv
馐	xqqg
鸺	xqjx
䗛	xqcv
需	xutl
虚	xuzc
徐	xuwx
须	xuew
许	xusn
续	xuim
序	xuxi
嘘	xudc
叙	xujr
恤	xuha
蓄	xulq
旭	xuko
戌	xunf
绪	xuio
絮	xubi
墟	xugc
胥	xutv
圩	xugn
栩	xuez
诩	xusz
吁	xudn
婿	xubv
昫	xuog
煦	xuoc
媭	xueb
勖	xuos
蓿	xulu
盱	xuqn
酗	xuym
顼	xunw
糈	xupv
溆	xukr
欻	xuce
洫	xuka
湑	xukv
畜	xuzq
醑	xuyv
浒	xukn
旴	xuon
垿	xugi
魆	xuan
谞	xusv
珝	xunz
㳚	xuki
冔	xuon
𦈡	xuil
𬣙	xusn
选	xrqu
癣	xrag
悬	xrfh
炫	xrci
玄	xrzi
宣	xrwf
旋	xrlt
轩	xrye
萱	xrlf
璇	xrnt
泫	xrki
渲	xrkf
喧	xrdf
玹	xrni
烜	xrcf
铉	xrzi
漩	xrkt
暄	xrof
瑄	xrnf
谖	xrsr
绚	xrio
楦	xref
券	xrhp
煊	xrcf
衒	xrpi
眩	xrqi
咺	xrdf
儇	xrjt
禤	xrfz
晅	xrof
翾	xryz
碹	xrmf
昡	xroi
琄	xrnv
痃	xrai
暶	xrot
愃	xrhf
𫍽	xrst
𫓶	xrzv
𫠊	xrni
学	xtkh
血	xtta
雪	xttb
薛	xtln
靴	xttv
穴	xtex
削	xtyp
谑	xtsb
噱	xtdj
鳕	xtwb
踅	xtup
茓	xtle
峃	xtkv
寻	xybk
熏	xylp
训	xyso
逊	xyhu
巡	xyou
勋	xyds
埙	xygo
巽	xyvh
讯	xysn
循	xywq
荀	xylo
旬	xyno
殉	xygo
薰	xylp
询	xyso
迅	xyau
洵	xyko
徇	xywo
驯	xyno
蕈	xyln
浔	xyei,xi
郇	xynt
鲟	xywk
荨	xylk
恂	xyho
醺	xyyp
栒	xyeo
曛	xyop
獯	xymp
汛	xykn
珣	xyno
噀	xydh
峋	xyvo
浚	xykh
𫄸	xyip
𬊈	xyck
𬍤	xynk
𬘓	xyio
𬩽	xybt
呀	yadl
压	yaxi
牙	yaly
鸭	yasx
亚	yafc
雅	yalu
押	yaus
丫	yahg
芽	yall
吖	yadg
娅	yabc
哑	yadc
崖	yavg
涯	yakg
氩	yavc
鸦	yalx
伢	yajl
衙	yapd
轧	yaya
蚜	yacl
垭	yagc
猰	yamm
玡	yanl
琊	yant
砑	yaml
桠	yaec
迓	yalu
讶	yasl
揠	yaub
睚	yaqg
岈	yavl
堐	yagg
盐	yjga
眼	yjqi
演	yjkh
烟	yjcm
言	yjsy
沿	yjkd
研	yjml
焉	yjfc
严	yjfx
颜	yjiw
腌	yjva
岩	yjvm
宴	yjwb
燕	yjlc
验	yjnf
炎	yjcc
咽	yjdm
延	yjtu
彦	yjie
阎	yjap
厌	yjxm
艳	yjam
掩	yjua
闫	yjat
焰	yjcp
淹	yjka
晏	yjob
俨	yjjx
雁	yjxu
鄢	yjft
妍	yjbl
嫣	yjbc
阏	yjaw
檐	yjes
偃	yjjb
焱	yjcc
衍	yjpk
阉	yjaa
砚	yjme
魇	yjxa
甗	yjzr
兖	yjap
谳	yjsm
筵	yjru
罨	yjya
赝	yjxo
弇	yjjl
湮	yjkg
酽	yjyx
奄	yjma
琰	yjnc
堰	yjgb
餍	yjxq
郾	yjnt
滟	yjkm
沇	yjkp
芫	yjlp
铅	yjzd
谚	yjse
黡	yjxp
嬿	yjbc
唁	yjds
胭	yjvm
蜒	yjcu
渰	yjkl
墕	yjgc
棪	yjec
戭	yjwp
掞	yjuc
蝘	yjcb
殷	yjzr
鼹	yjpb
崦	yjva
厣	yjxs
恹	yjhm
漹	yjkc
虤	yjzz
扊	yjmc
䶮	yjtm
觃	yjeh
𪩘	yjvm
𫄧	yjiu
𬙂	yjih
𬸘	yjnx
杨	yhee
养	yhgp
羊	yhgy
样	yheg
氧	yhvg
阳	yhto
痒	yhag
洋	yhkg
扬	yhue
央	yhmm
仰	yhjz
漾	yhkk
鞅	yhtm
旸	yhoe
秧	yhxm
佯	yhjg
烊	yhcg
殃	yhgm
飏	yhoe
炀	yhce
钖	yhze
羕	yhgk
疡	yhae
鸯	yhmx
恙	yhgh
垟	yhgg
蛘	yhcg
泱	yhkm
怏	yhhm
玚	yhne
徉	yhwg
咉	yhdm
要	ycvb
药	ycli
腰	ycvb
妖	ycbm
咬	ycdb
邀	ycuu
摇	ycua
尧	ycpp
姚	ycbw
舀	ycyp
约	ycii
幺	yciy
曜	ycou
瑶	ycna
谣	ycsa
窑	ycea
遥	ycyu
垚	ycgg
爻	ycbb
夭	yctm
耀	ycmu
吆	ycdi
杳	yceo
窈	yces
峣	ycvp
肴	ycbv
徭	ycwa
钥	yczv
鳐	ycwa
窅	yceq
鹞	ycyx
铫	yczw
珧	ycnw
轺	ycyd
疟	ycab
靿	ycts
侥	ycjp
崾	ycvb
猺	ycma
媱	ycba
㙘	ycgb
也	yeey
页	yewy
叶	yedn
野	yedi
夜	yezv
业	yecy
耶	yeqt
液	yekv
爷	yehz
噎	yedz
邺	yect
掖	yeuv
谒	yesf
椰	yeet
曳	yeot
冶	yewd
晔	yeon
烨	yecn
铘	yezt
腋	yevv
靥	yexb
倻	yejt
咽	yedm
馌	yeqa
揶	yeut
以	yivj
一	yifi
亿	yija
已	yivi
亦	yizc
易	yioe
矣	yiko
乙	yiai
译	yisu
意	yixh
仪	yijb
依	yijt
咦	yidb
伊	yijt
椅	yiez
衣	yiti
医	yino
义	yiib
翼	yizh
宜	yiwf
异	yivl
裔	yitd
益	yika
邑	yidm
移	yixl
壹	yigz
役	yiwr
奕	yizm
夷	yimb
艺	yila
疑	yivt
倚	yijz
逸	yiwu
姨	yibb
忆	yiha
遗	yicu
议	yisb
蚁	yicb
噫	yidh
抑	yiuz
怡	yihd
乂	yibi
铱	yizt
溢	yika
驿	yinu
疫	yiar
翊	yiiz
埸	yige
胰	yivb
刈	yibp
颐	yiqw
毅	yiir
钇	yiza
懿	yigh
诣	yiso
彝	yibl
揖	yiuq
弋	yipi
翳	yinz
轶	yiyh
羿	yizl
祎	yifg
猗	yimz
尾	yicv
镒	yiza
贻	yiod
佚	yijh
燚	yicc
谊	yisf
弈	yizl
诒	yisd
咿	yidt
扆	yimt
镱	yizh
佾	yijv
浥	yikm
臆	yivh
瘗	yiag
缢	yiia
沂	yikt
殪	yigz
峄	yivu
圯	yigv
绎	yiiu
熠	yicu
迤	yieu
劓	yiop
翌	yizi
漪	yikz
苡	yilj
饴	yiqd
嶷	yivt
匜	yine
屹	yiva
肄	yivb
挹	yium
裛	yitm
潩	yikh
舣	yiib
怿	yihu
踦	yipz
螠	yica
嗌	yida
簃	yirl
薏	yilh
黟	yipl
洢	yikt
繄	yini
荑	yilb
旖	yilz
佁	yijd
悒	yihm
嫕	yibh
鹢	yikx
勚	yils
呓	yida
眙	yiqd
蜴	yice
酏	yiye
鹝	yinx
艾	yilb
廙	yixh
枍	yiea
癔	yiah
痍	yiab
杙	yiep
宧	yiwq
椸	yiee
扅	yiml
㑊	yijc
𫄷	yiih
𫖮	yivw
𬟁	yilx
𬬩	yizp
𬺈	yilz
因	ybrm
音	ybxy
银	ybzi
印	ybbz
引	ybbg
阴	ybtv
饮	ybqe
隐	ybth
瘾	ybah
殷	ybzr
尹	ybbt
吟	ybda
寅	ybwh
荫	yblv
淫	ybkg
胤	ybpv
龈	ybli
铟	ybzm
洇	ybkm
蚓	ybcg
茵	yblm
鄞	yblt
堙	ybgg
愔	ybhx
骃	ybnm
喑	ybdx
垠	ybgi
窨	ybex
氤	ybvm
禋	ybfg
嚚	ybdd
霪	ybtg
姻	ybbm
訚	ybas
龂	yblt
崟	ybvz
慭	ybah
夤	yblh
溵	ybkr
茚	yblz
狺	ybms
蟫	ybcn
吲	ybdg
硍	ybmi
珢	ybni
歅	ybve
䲟	ybwz
𬘡	ybim
𬤇	ybsg
𬮱	ybag
应	ykxf
硬	ykmb
赢	ykfi
英	yklm
营	ykld
樱	ykeb
影	ykoe
鹰	ykxx
迎	ykbu
盈	ykva
嬴	ykfi
郢	ykdt
嘤	ykdb
瑛	yknm
蝇	ykcd
颖	ykvw
映	ykom
莺	yklx
萤	yklc
婴	ykob
瀛	ykki
莹	ykli
颍	ykvw
媵	ykvb
鹦	ykox
膺	ykxv
瘿	ykab
缨	ykib
楹	ykea
荧	yklc
萦	ykli
罂	ykoa
撄	ykub
锳	ykzm
滢	ykki
荥	yklk
溁	ykke
潆	ykki
蓥	yklz
璎	yknb
茔	yklg
媖	ykbm
䓨	ykla
哟	yodi
唷	yodv
育	yobv
用	ysty
勇	ysks
永	ysik
咏	ysdk
拥	ysut
涌	yskt
庸	ysxt
蛹	ysct
雍	yszu
颙	ysqw
俑	ysjt
佣	ysjt
慵	ysht
泳	yskk
踊	yspt
壅	yszg
痈	ysat
甬	yskt
鳙	yswt
饔	yszq
邕	ysom
镛	yszt
鄘	ysxt
澭	ysku
臃	ysvu
墉	ysgt
喁	ysdv
恿	yskh
埇	ysgt
栐	ysek
㶲	ysct
鲬	yswt
有	yznv
又	yzry
由	yzdy
油	yzkd
右	yznd
游	yzkh
哟	yzdi
呦	yzds
优	yzjo
友	yznr
尤	yzoy
铀	yzzd
鼬	yzpd
犹	yzmo
佑	yzjd
祐	yzfd
忧	yzho
幽	yzvi
釉	yztd
幼	yzis
邮	yzdt
酉	yzyy
疣	yzao
诱	yzsv
悠	yzjh
柚	yzed
宥	yzwv
鱿	yzwo
攸	yzjh
繇	yzyi
囿	yzrv
卣	yzyn
侑	yzjv
铕	yzzv
猷	yzhm
牖	yzan
莠	yzlv
蚴	yzcs
麀	yzxv
羑	yzgi
鲉	yzwd
莜	yzlh
黝	yzps
莸	yzlo
耰	yzah
槱	yzec
蝤	yzcy
浟	yzkh
蝣	yzch
蚰	yzcd
𬨎	yzyy
与	yuff
于	yufn
鱼	yuwv
宇	yuwn
於	yulw
欲	yuhe
语	yusd
雨	yutv
余	yujx
预	yuiw
玉	yuni
羽	yuzv
域	yugf
瑜	yunp
遇	yuqu
御	yuwz
禹	yutv
逾	yuju
愈	yujh
俞	yujp
虞	yuzm
渔	yukw
予	yuiv
豫	yuiw
愚	yuqh
驭	yunr
喻	yudp
渝	yukp
裕	yuth
育	yubv
郁	yunt
狱	yumm
瘀	yuaw
浴	yukh
舆	yuph
彧	yupe
娱	yubm
鹬	yuix
芋	yuln
峪	yuvh
誉	yuks
隅	yutv
昱	yuoi
欤	yufe
谕	yusp
榆	yuep
寓	yuwv
淤	yukw
鬻	yubn
煜	yuci
毓	yueo
阈	yuaf
圉	yurg
聿	yubv
吁	yudn
瑀	yunv
鄅	yutt
庾	yuxj
愉	yuhp
盂	yufa
钰	yuzi
迂	yufu
屿	yuvf
禺	yuqv
竽	yurn
遹	yuiu
淯	yukv
妤	yubi
窳	yuey
纡	yuin
妪	yubb
鹆	yuhx
俣	yujm
喁	yudv
棫	yuef
燠	yucm
雩	yuta
腴	yuvj
舁	yupl
玙	yunf
谀	yusj
矞	yuid
敔	yuwh
饫	yuqm
畬	yujq
熨	yucc
潏	yukd
堉	yugv
嵛	yuvp
蜮	yucf
圄	yurd
艅	yuix
揄	yuup
萸	yulj
邘	yuft
臾	yupj
褕	yutp
燏	yucd
窬	yuep
髃	yufv
瘐	yuaj
觎	yuje
龉	yuld
嵎	yuvv
尉	yuck
蔚	yulk
狳	yumx
滪	yukw
伛	yujb
蝓	yucp
蓣	yulw
悆	yujh
㺄	yump
元	yrmp
原	yrxy
远	yrmu
源	yrky
愿	yrxh
圆	yrro
院	yrtp
员	yrdo
园	yrrp
袁	yrgt
猿	yrmt
缘	yrij
怨	yrlh
冤	yrww
苑	yrlz
渊	yrkp
援	yrur
爰	yryr
垣	yrgf
鸢	yrpx
螈	yrcy
鼋	yrmd
沅	yrkp
妧	yrbp
媛	yrbr
掾	yruj
塬	yrgy
瑗	yrnr
鸳	yrlx
嫄	yrby
辕	yryt
芫	yrlp
涴	yrkz
垸	yrgp
橼	yrej
蜎	yrcv
眢	yrlq
圜	yrrt
湲	yrkr
箢	yrrz
羱	yrgy
𫘪	yrny
月	ytvy
越	ytpn
约	ytii
曰	ytor
粤	ytta
岳	yttv
乐	ytby
悦	ythp
阅	ytap
跃	ytpm
钺	ytzn
玥	ytnv
樾	yten
刖	ytvp
籥	ytrd
龠	ytjd
瀹	ytkd
哕	ytdl
栎	ytey
爚	ytcd
钥	ytzv
彟	ytbr
𫐄	ytyp
𬸚	ytmx
云	yyby
运	yybu
晕	yyoy
韵	yyxw
孕	yyvh
匀	yynw
允	yykp
熨	yycc
芸	yylb
陨	yyto
愠	yyha
筠	yyrw
蕴	yyla
殒	yygo
昀	yyow
妘	yybb
赟	yyvo
狁	yymp
韫	yyga
恽	yyhy
氲	yyva
缊	yyia
郓	yywt
耘	yyab
郧	yydt
酝	yyyb
筼	yyro
煴	yyca
沄	yykb
纭	yyib
鋆	yygz
涢	yyko
员	yydo
馧	yyxa
𫖳	yybw
咋	zadw
砸	zamr
杂	zake
咂	zadr
匝	zanr
扎	zaua
拶	zaul
臜	zavo
在	zdng
再	zdfg
载	zdny
哉	zdnd
崽	zdvh
宰	zdwn
仔	zdjh
栽	zdne
灾	zdwc
甾	zdoq
赞	zjqo
咱	zjdo
攒	zjuo
暂	zjyo
簪	zjro
錾	zjyz
瓒	zjno
拶	zjul
昝	zjho
酂	zjqt
趱	zjpo
糌	zjpo
寁	zjws
脏	zhvg
葬	zhll
臧	zhnq
藏	zhlq
牂	zhag
赃	zhog
奘	zham
驵	zhnf
早	zcon
造	zcqu
遭	zcfu
灶	zccg
糟	zcpo
枣	zcew
凿	zccm
澡	zcke
皂	zcur
燥	zcce
躁	zcpe
藻	zcle
噪	zcde
蚤	zcrc
璪	zcne
慥	zchu
簉	zcru
唣	zcdr
𥖨	zcme
则	zeop
啧	zedo
泽	zeku
择	zeuu
责	zeao
仄	zexj
帻	zero
昃	zeoj
咋	zedw
迮	zewu
笮	zerw
箦	zero
赜	zeqo
舴	zeiw
贼	zwon
鲗	zwwp
怎	zfwh
谮	zfso
增	zggo
赠	zgoo
甑	zghr
缯	zgio
曾	zgho
憎	zgho
鄫	zght
罾	zgyo
矰	zgoo
锃	zgzn
综	zgif
䎖	zghz
炸	vacw
渣	vakf
扎	vaua
榨	vaew
乍	vawa
札	vaea
闸	vaas
诈	vasw
眨	vaqr
吒	vadr
栅	vaei
咤	vadr
铡	vazp
轧	vaya
揸	vauf
鲊	vaww
砟	vamw
楂	vaef
劄	varp
喳	vadf
霅	vats
拃	vauw
咋	vadw
溠	vaku
哳	vadt
奓	vaml
蚱	vacw
查	vaef
馇	vaqf
挓	vaur
柞	vaew
喋	vade
痄	vaaw
䃎	vaml
鲝	vagw
齇	vaof
债	vdjo
窄	vdew
宅	vdwr
摘	vduc
寨	vdwe
斋	vdvl
翟	vdzu
祭	vdhf
择	vduu
瘵	vdaf
豸	vdmi
站	vjid
占	vjyd
战	vjyp
斩	vjyt
粘	vjpd
沾	vjkd
展	vjct
詹	vjxs
蘸	vjlc
栈	vjep
盏	vjfa
毡	vjvd
瞻	vjqs
旃	vjlz
绽	vjit
湛	vjka
辗	vjyt
鳣	vjwf
鹯	vjzx
飐	vjod
崭	vjvt
栴	vjez
谵	vjss
偡	vjja
搌	vjut
𫗴	vjqf
张	vhbp
章	vhxn
涨	vhkp
长	vhpc
帐	vhrp
账	vhop
仗	vhjb
掌	vhsu
杖	vheb
胀	vhvp
丈	vhfb
彰	vhxe
障	vhtn
璋	vhnn
蟑	vhcn
鄣	vhxt
瘴	vhan
漳	vhkn
嶂	vhvn
獐	vhmn
樟	vhen
幛	vhrn
仉	vhjo
嫜	vhbn
暲	vhon
找	vcup
招	vcud
赵	vcpb
照	vcoc
兆	vcpw
罩	vcyn
诏	vcsd
昭	vcod
召	vcpd
朝	vcnv
着	vcgq
棹	vcen
肇	vcmb
钊	vczp
沼	vckd
曌	vcou
爪	vcya
旐	vclw
笊	vcry
啁	vcdd
𬬿	vczd
𬶐	vcww
这	vevu
者	veqo
着	vegq
折	veut
浙	vekt
遮	vexu
哲	veud
辄	veya
锗	vezo
褶	vetu
蛰	veuc
辙	veyh
啫	vedo
柘	veem
谪	vesc
蜇	veuc
喆	vegd
磔	veme
赭	vego
蔗	velc
晢	veuo
詟	vets
鹧	vexx
䗪	vexc
真	vfnh
朕	vfvm
镇	vfzh
帧	vfro
针	vfzn
阵	vfty
枕	vfep
震	vftf
臻	vfyx
珍	vfne
甄	vfvr
振	vfuf
贞	vfyo
箴	vfrd
诊	vfse
缜	vfih
斟	vfzj
侦	vfjo
鸩	vfwx
砧	vfmd
赈	vfof
祯	vffo
轸	vfye
榛	vfex
疹	vfae
桢	vfeo
胗	vfve
圳	vfgo
畛	vfqe
稹	vfxh
禛	vffh
鬒	vfph
瑧	vfnx
葴	vfld
蓁	vflx
揕	vfua
袗	vfte
浈	vfko
昣	vfoe
纼	vfig
正	vgfs
证	vgss
挣	vgub
蒸	vglc
整	vgxs
症	vgas
争	vgxb
郑	vght
征	vgws
政	vgfh
睁	vgqb
筝	vgrb
怔	vghs
烝	vgac
钲	vgzs
铮	vgzb
狰	vgmb
拯	vguf
峥	vgvb
诤	vgsb
只	vidh
之	viri
至	viyi
值	vijf
指	viuo
纸	viib
制	viqp
治	vikd
直	vinf
知	viod
支	vici
致	viyh
质	vixo
汁	vikn
志	vigh
置	viyf
智	vioo
止	visi
酯	viyo
职	viqh
执	viui
掷	viut
枝	viec
痣	viah
脂	vivo
趾	vips
彘	vibv
织	viih
吱	vidc
芝	vilr
植	vief
滞	vikr
跖	vipm
炙	vivc
秩	vixh
旨	vivo
侄	vijy
徵	viwh
祗	vifi
栀	viez
芷	vils
址	vigs
雉	viou
窒	viey
肢	vivc
陟	vits
痔	viak
沚	viks
枳	vieh
栉	viez
稚	vixu
卮	vixz
挚	viuu
郅	viyt
轵	viyh
殖	vigf
畤	viqk
峙	vivk
絷	viui
帙	virh
摭	viuc
蛭	vicy
鸷	viux
铚	vizy
蜘	vicd
踬	vipo
祉	vifs
埴	vigf
帜	virh
豸	vimi
扺	viub
贽	viuo
锧	vizo
骘	vitn
踯	vipt
咫	vich
觯	vixn
桎	viey
滍	vikc
泜	viki
黹	vicf
轾	viyy
跱	vipk
忮	vihc
氏	vibs
稙	vixf
疐	vint
识	vish
禔	vift
胝	vivi
晊	vioy
庤	vixk
梽	vieh
榰	vieo
𦭜	vilh
𬃊	vieo
中	vsdg
种	vsxg
重	vsld
众	vsjj
钟	vszg
终	vsiw
忠	vsdh
肿	vsvg
冢	vswi
仲	vsjg
盅	vsda
锺	vszd
柊	vsew
踵	vspd
衷	vstg
舯	vsig
螽	vshc
茽	vslg
周	vzmd
轴	vzyd
州	vzoo
粥	vzbb
咒	vzdo
肘	vzvk
洲	vzko
舟	vzio
皱	vzxr
昼	vzcf
纣	vzik
胄	vzdv
骤	vznk
宙	vzwd
籀	vzrq
酎	vzyk
诌	vzsb
绉	vzib
帚	vzbr
辀	vzyi
啁	vzdd
鸼	vzix
赒	vzod
碡	vzmk
婤	vzbd
妯	vzbd
荮	vzlk
㑇	vzjb
㤘	vzhb
主	vuin
住	vujn
注	vukn
煮	vuqc
猪	vumo
祝	vufp
著	vulo
朱	vuta
柱	vuen
诸	vuso
助	vufs
驻	vunn
竹	vuru
诛	vusa
渚	vuko
珠	vuna
株	vuea
铸	vuzk
逐	vuju
筑	vuri
蛛	vuca
箸	vuro
邾	vutt
铢	vuza
烛	vucc
蛀	vucn
贮	vuof
嘱	vudv
拄	vuun
炷	vucn
洙	vuka
茱	vula
伫	vujf
竺	vurm
纻	vuif
瞩	vuqv
苎	vulf
麈	vuxn
槠	vueo
舳	vuid
疰	vuan
杼	vuei
潴	vuko
侏	vuja
翥	vuqz
砫	vumn
柷	vuep
躅	vupc
蠋	vucc
橥	vume
术	vuei
瘃	vuai
𬣞	vusf
抓	vxuy
爪	vxya
髽	vxpg
拽	vkut
转	vryi
赚	vroc
专	vrmi
砖	vrmi
撰	vruh
传	vrji
篆	vrrj
馔	vrqh
颛	vrvw
僎	vrjh
啭	vrdi
瑑	vrnj
沌	vrks
䏝	vrvi
装	vlat
状	vlam
撞	vlud
庄	vlxg
妆	vlab
桩	vleg
壮	vlag
幢	vlrd
戆	vlxh
奘	vlam
追	vvtu
坠	vvtg
锥	vvzu
缀	vvir
椎	vveu
隹	vvui
骓	vvnu
赘	vvao
缒	vviu
惴	vvhl
准	vywu
肫	vyvs
屯	vyfs
谆	vysh
窀	vyes
衠	vyph
𬘯	vyih
桌	voye
捉	voup
啄	vodi
卓	voyn
浊	vokc
灼	voci
着	vogq
拙	voum
斫	vomt
酌	voyi
叕	vorr
擢	vouu
濯	voku
焯	vocn
镯	vozc
琢	voni
涿	voki
汋	voki
倬	vojn
茁	volm
浞	vokp
椓	voei
禚	vofc
诼	vosi
棁	voep
晫	voon
䓬	voln
䦃	vozo
𬸦	volx
字	ziwh
自	zioi
子	zihi
紫	zisi
兹	zihi
资	ziwo
仔	zijh
籽	ziph
姿	ziwb
滋	ziki
渍	ziko
梓	zien
嗞	zidi
姊	zibt
咨	ziwd
恣	ziwh
赀	ziso
訾	ziss
髭	zipv
笫	zirt
粢	ziwp
吱	zidc
缁	ziiq
孖	zihh
眦	ziqv
孳	zihh
觜	zist
龇	zilv
孜	zihh
滓	zikn
辎	ziyq
淄	zikq
秭	zixt
茈	zilv
镃	zizi
耔	ziah
嵫	zivi
鼒	zina
虸	zich
锱	zizq
趑	zipe
鲻	ziwq
鄑	zift
总	zshh
宗	zswf
纵	zsij
棕	zsef
综	zsif
粽	zspf
踪	zspf
鬃	zspf
腙	zsvf
疭	zsaj
倧	zsjf
枞	zsej
鬷	zsnh
偬	zsjh
走	zzpz
揍	zzum
奏	zzam
邹	zzxt
陬	zztr
诹	zzsr
驺	zznb
鲰	zzwr
鄹	zzqt
组	zuif
族	zulo
足	zupu
租	zuxf
卒	zuzn
祖	zuff
阻	zutf
俎	zujf
菹	zulf
镞	zuzo
诅	zusf
崒	zuvn
珇	zunf
钻	zrzd
攥	zrui
纂	zrri
缵	zrio
躜	zrpo
最	zvor
嘴	zvdt
罪	zvyr
醉	zvyn
蕞	zvlr
槜	zvev
咀	zvdf
尊	zyhk
遵	zyhu
樽	zyek
鳟	zywk
噂	zydk
撙	zyuk
僔	zyjk
嶟	zyvk
𨱔	zyzk
做	zojh
作	zojw
坐	zojg
左	zonu
座	zoxg
佐	zoju
嘬	zodr
昨	zoow
撮	zour
唑	zodg
酢	zoyw
祚	zofw
琢	zoni
怍	zohw
阼	zotw
胙	zovw
捽	zoun
柞	zoew
笮	zorw
岞	zovw
