啊	aaoo
阿	aapo
吖	aaoy
锕	aazo
腌	aanl
爱	aija
哎	aiox
唉	aior
艾	aihx
挨	aifr
癌	aije
矮	aiva
哀	aiik
埃	aiyr
碍	aipd
欸	aiuv
砹	aipx
隘	aipq
瑷	aiia
暧	aiba
毐	aiyq
嗳	aioa
蔼	aihl
锿	aizk
霭	aitl
嗌	aioq
叆	aiga
嫒	aiaa
皑	aijl
按	anfa
安	anna
案	annm
俺	anvl
暗	anbb
氨	anka
胺	anna
庵	anjl
岸	anet
鞍	anha
黯	anib
铵	anza
桉	anma
唵	anol
谙	anib
埯	anyl
盦	anvq
垵	anya
犴	anqt
鹌	anrs
𩽾	anua
昂	ahbp
卬	ahcp
盎	ahrq
肮	ahnw
奥	aojr
熬	aoyd
嗷	aooa
澳	aodr
凹	aooi
傲	aova
敖	aoya
鳌	aoyu
袄	aotr
螯	aoyc
拗	aofx
坳	aoyx
獒	aoyd
媪	aoaq
岙	aoje
翱	aoje
遨	aoyz
鏊	aoyz
薁	aohr
懊	aolr
璈	aoia
鏖	aojz
骜	aoys
隩	aopr
聱	aoyb
奡	aotg
廒	aoja
嶅	aoye
吧	baol
把	bafl
八	bagj
巴	balz
扒	bafg
拔	bafd
罢	baqu
叭	baog
爸	bagl
靶	bahl
钯	bazl
疤	bajl
霸	batn
芭	bahl
耙	baml
坝	bayr
灞	badn
捌	bafg
跋	baed
粑	bagl
魃	bawd
鲃	baul
妭	baad
鲅	baud
菝	bahd
羓	bayl
胈	band
朳	bamg
笆	bakl
岜	bael
蚆	bacl
白	bljb
摆	blfu
拜	bljt
百	bltb
掰	blff
败	blra
柏	blmb
佰	blvb
稗	blux
捭	blfx
伯	blvb
版	bjka
班	bjii
半	bjgf
板	bjma
般	bjna
办	bjxg
搬	bjfa
拌	bjff
斑	bjii
伴	bjvf
瓣	bjix
扮	bjfh
扳	bjfa
绊	bjwf
颁	bjgr
坂	bjya
阪	bjpa
钣	bjza
癍	bjji
柈	bjmf
攽	bjga
瘢	bjja
昄	bjba
湴	bjdh
靽	bjhf
𨭉	bjiz
帮	bhfe
棒	bhmf
榜	bhmh
磅	bhph
邦	bhfw
绑	bhwp
镑	bhzh
傍	bhvh
蚌	bhcf
浜	bhdg
谤	bhih
梆	bhmp
膀	bhnh
搒	bhfh
玤	bhif
蒡	bhhh
塝	bhyh
𠳐	bhow
包	bkhl
宝	bknd
报	bkfa
保	bkvm
爆	bkrx
抱	bkfl
薄	bkhd
堡	bkvy
曝	bkbx
饱	bkkl
鲍	bkul
煲	bkvr
剥	bkeg
暴	bkbx
豹	bkqd
刨	bkhg
褒	bkik
胞	bknl
葆	bkhm
苞	bkhl
鸨	bkls
炮	bkrl
雹	bktl
孢	bkzl
枹	bkml
龅	bkyl
趵	bked
褓	bktm
瀑	bkdx
被	bzta
背	bzxn
倍	bzvo
呗	bzor
杯	bzmt
北	bzxi
贝	bzri
备	bzaq
悲	bzxu
碑	bzpx
辈	bzxl
钡	bzzr
焙	bzro
邶	bzxw
卑	bzjx
悖	bzlz
孛	bzxz
蓓	bzho
陂	bzpa
碚	bzpo
琲	bzix
惫	bzau
鹎	bzjs
鞴	bzhf
狈	bzqr
棓	bzmo
椑	bzmx
褙	bztn
糒	bzgf
臂	bzpn
鐾	bzpz
鞁	bzha
𬇙	bzdr
本	bfmh
笨	bfkm
奔	bfrh
苯	bfhm
畚	bfuq
贲	bfxr
锛	bfzh
犇	bfff
坌	bfgy
夯	bfrx
倴	bfvh
栟	bfmh
崩	bgen
蹦	bgen
泵	bgpx
甭	bgtf
绷	bgwn
嘣	bgon
迸	bgkz
甏	bgya
蚌	bgcf
琫	bgif
祊	bgth
镚	bgzn
比	bill
笔	bikl
逼	bihz
必	biul
币	bije
鼻	bijk
臂	bipn
壁	bipy
彼	biva
毕	bilx
避	bipz
碧	biip
哔	biox
闭	binj
弊	bigh
璧	bipd
铋	bizu
敝	biga
匕	bill
毙	bill
俾	bivx
鄙	biop
蔽	biha
婢	biax
濞	bidk
庇	bijl
畀	biqk
陛	bipy
弼	biww
痹	bijk
妣	bial
髀	binx
吡	biol
屄	bipg
箅	bikk
滗	bidl
庳	bijx
嬖	bipa
芘	bihl
沘	bidl
毖	bilu
蓖	bihl
裨	bitx
苾	bihu
愎	bila
篦	bikl
邲	biuw
皕	bitb
襞	bipk
萆	bihx
荜	bihx
薜	bihx
跸	biex
咇	biou
珌	biiu
舭	binl
辟	bipx
佖	bivu
赑	birr
荸	bihz
诐	biia
筚	bikx
秕	biul
贲	bixr
狴	biqy
佛	bivs
觱	bisf
馝	biuu
泌	bidu
秘	biuu
鲾	biuq
坒	bily
便	bmvr
边	bmxz
变	bmia
遍	bmdz
编	bmwh
贬	bmrz
辩	bmix
扁	bmdh
鞭	bmhr
辨	bmix
蝙	bmch
卞	bmdt
煸	bmrh
弁	bmuh
辫	bmix
匾	bmch
汴	bmdt
抃	bmft
昪	bmbh
苄	bmht
笾	bmkx
砭	bmpz
鳊	bmuh
萹	bmhh
忭	bmlt
碥	bmph
褊	bmth
𨚕	bmuw
𰻝	bdnz
表	bcyk
标	bcmg
婊	bcak
飙	bcrx
镖	bczg
彪	bcjg
裱	bctk
膘	bcng
杓	bcmd
鳔	bcug
镳	bczd
骉	bcss
熛	bcrg
摽	bcfg
幖	bceg
骠	bcsg
藨	bchd
儦	bcvd
瀌	bcdd
俵	bcvk
飑	bcwl
瘭	bcjg
脿	bcnk
别	bxog
憋	bxgu
鳖	bxgu
瘪	bxjl
蹩	bxge
癿	bxjl
宾	bnng
斌	bniy
彬	bnmg
髌	bnng
鬓	bnfg
滨	bndg
豳	bneq
邠	bngp
缤	bnwg
膑	bnng
殡	bnhg
濒	bndr
摈	bnfg
玢	bnih
傧	bnvg
镔	bnzg
槟	bnmg
并	bykh
病	byjn
兵	byog
冰	bydx
饼	bykh
柄	bymn
丙	byhn
禀	byig
屏	byph
秉	bymj
炳	byrn
蛃	bycn
昺	bybn
摒	byfh
槟	bymg
邴	byhp
栟	bymh
波	boda
博	boxd
播	bofq
薄	bohd
拨	bofd
伯	bovb
铂	bozb
搏	bofd
啵	booa
钵	bozm
勃	boxx
驳	bosx
玻	boia
脖	bonz
帛	boje
剥	boeg
跛	boea
亳	boil
箔	bokb
柏	bomb
孛	boxz
泊	bodb
钹	bozd
渤	bodx
镈	bozd
僰	bomv
菠	boha
擘	bopf
浡	bodz
舶	bonb
嶓	boeq
膊	bond
哱	booz
砵	bopm
卜	boli
踣	boeo
簸	boka
鹁	boxs
檗	bopm
鲌	boub
蕃	bohq
艴	bosl
趵	boed
馞	bouz
袯	botd
饽	bokz
礴	bopd
欂	bomd
𬭛	boza
不	buth
部	buip
补	butl
步	buyg
布	buxe
簿	bukd
钚	buzt
捕	buff
卜	buli
怖	bule
卟	buol
晡	bubf
埠	buyx
逋	bufz
堡	buvy
哺	buof
蔀	buhp
瓿	buia
醭	busn
埔	buyf
埗	buyg
𬷕	bufs
擦	cafg
嚓	caog
才	clxj
菜	clhm
踩	clem
猜	clqn
蔡	clhg
财	clrj
采	cljm
材	clmj
裁	clxk
彩	cljg
睬	clbm
偲	clvu
惨	cjlg
餐	cjlk
残	cjhs
参	cjug
蚕	cjhc
粲	cjlm
灿	cjre
骖	cjsg
惭	cjlt
璨	cjim
黪	cjig
䅟	cjug
藏	chhc
仓	chvl
舱	chnl
苍	chhl
沧	chdl
鸧	chvs
伧	chvl
草	ckhx
槽	ckmb
曹	cksb
操	ckfm
艹	ckhh
糙	ckgz
屮	ckel
嘈	ckob
漕	ckdb
芔	ckee
肏	ckvv
艚	cknb
螬	ckcb
𥕢	ckpb
侧	cevg
测	cedg
册	cehj
策	cekm
厕	cejg
恻	celg
𤭢	czia
岑	cfez
涔	cfdz
参	cfug
曾	cggb
层	cgpu
蹭	cgeb
噌	cgob
嶒	cgeb
差	iayi
茶	iahm
查	iamh
插	iafu
叉	iaad
侘	iavl
茬	iahy
镲	iazg
察	iang
猹	iaqh
搽	iafm
槎	iami
岔	iage
檫	iamg
杈	iamd
嚓	iaog
碴	iaph
姹	iaal
汊	iadd
衩	iatd
锸	iazu
垞	iayl
诧	iail
馇	iakh
刹	iaxg
喳	iaoh
蹅	iaeh
嵖	iaeh
𥻗	iagh
拆	ilft
柴	ilym
差	ilyi
钗	ilzd
豺	ilqj
虿	ilhc
侪	ilvg
瘥	ilji
茝	ilhc
产	ijij
铲	ijzj
馋	ijkg
缠	ijwi
禅	ijtt
蝉	ijct
掺	ijfg
颤	ijir
搀	ijfg
谗	ijig
浐	ijdj
婵	ijat
蟾	ijci
澶	ijdh
觇	ijlw
阐	ijnt
躔	ijey
襜	ijti
谄	ijiu
镡	ijzx
刬	ijsg
辿	ijez
忏	ijlx
巉	ijed
韂	ijhi
羼	ijpy
廛	ijjy
潺	ijdz
梴	ijmz
孱	ijpz
蒇	ijhr
啴	ijot
单	ijgt
骣	ijsz
镵	ijzd
瀍	ijdy
旵	ijbe
冁	ijgk
儳	ijvd
𬊤	ijrt
唱	ihob
场	ihyg
长	ihkj
常	ihge
厂	ihjh
尝	ihgu
肠	ihng
畅	ihfg
昌	ihbb
偿	ihvu
敞	ihga
娼	ihab
鬯	ihxl
怅	ihlk
倡	ihvb
昶	ihib
猖	ihqb
嫦	ihae
氅	ihgl
伥	ihvk
苌	ihhk
鲳	ihub
菖	ihhb
徜	ihvo
裳	ihgk
阊	ihnb
鲿	ihuu
惝	ihlo
𬬮	ihzk
超	ikeo
抄	ikfj
炒	ikrj
朝	ikxn
潮	ikdn
吵	ikoj
钞	ikzj
巢	ikgm
嘲	ikon
焯	ikrx
晁	ikbx
怊	iklo
绰	ikwx
弨	ikwo
耖	ikmj
车	ielh
扯	iefy
撤	iefa
彻	ievh
掣	iejf
澈	ieda
坼	ieyt
尺	iepn
砗	iepl
㬚	ieba
陈	ifpl
趁	ifeg
臣	ifch
沉	ifdw
辰	ifjk
尘	ifgy
琛	ifim
抻	ifff
嗔	ifog
衬	iftd
晨	ifbk
称	ifug
宸	ifnk
谶	ifih
谌	ifil
瞋	ifbg
忱	iflw
梣	ifmz
煁	ifrl
榇	ifmm
龀	ifyl
疢	ifjr
棽	ifmz
碜	ifpg
郴	ifmp
𬘭	ifwm
成	igsz
称	igug
城	igyz
呈	igoi
乘	igux
撑	igff
橙	igmk
程	igui
秤	igug
盛	igsq
承	igzx
诚	igiz
丞	igwh
澄	igdk
逞	igoz
惩	igvu
枨	igmk
埕	igyi
骋	igss
铖	igzz
澂	igda
珵	igii
琤	igit
塍	igny
偁	igvn
蛏	igcy
赪	igyr
噌	igob
酲	igsi
宬	ignz
柽	igmy
瞠	igby
珹	igiz
牚	iggr
晟	igbz
铛	igze
憕	iglk
裎	igti
庱	igja
吃	iioz
池	iidl
持	iifd
赤	iiyx
尺	iipn
迟	iipz
齿	iiyu
敕	iima
痴	iijo
驰	iisl
翅	iixe
耻	iiby
嗤	iioc
豉	iiha
斥	iijt
螭	iicn
叱	iiol
彳	iivj
蚩	iiec
炽	iirg
笞	iiko
哧	iiox
媸	iiac
饬	iikx
侈	iivd
弛	iiwl
褫	iitw
魑	iiwn
摛	iifn
鸱	iijs
啻	iiio
瘛	iiju
漦	iimx
墀	iiyf
茌	iihy
匙	iibl
眵	iibd
篪	iikw
傺	iivg
踟	iieo
胣	iinl
瓻	iixa
痓	iijy
𫄨	iiwe
冲	isdf
重	isij
充	isiw
虫	isci
宠	isnw
崇	iseg
铳	iszw
舂	isru
憧	isli
摏	isfu
艟	isni
翀	isef
忡	islf
茺	ishw
涌	isdf
种	isuf
珫	isiw
漴	isdg
㳘	isdw
抽	ibfy
丑	ibzh
臭	ibjd
愁	ibuu
瞅	ibbr
仇	ibvx
筹	ibkd
稠	ibuo
酬	ibsg
雠	ibvi
俦	ibvd
绸	ibwo
畴	ibqd
瘳	ibjg
惆	iblo
杻	ibmh
帱	ibed
椆	ibmo
犨	ibvf
踌	ibed
侴	ibvg
出	iueu
处	iual
除	iupm
初	iuth
楚	iumv
厨	iujd
触	iuhc
褚	iutb
杵	iumx
储	iuvb
锄	iuzx
怵	iuld
雏	iuhi
橱	iumd
畜	iuiq
黜	iuiu
刍	iuhe
础	iupu
俶	iuva
楮	iumb
矗	iuxb
亍	iuht
滁	iudm
绌	iuwu
樗	iums
憷	iulv
斶	iujc
搐	iufq
摴	iufs
躇	iueb
蜍	iucm
濋	iudv
蹰	iued
䝙	iuqx
䢺	iuep
琡	iuia
𬺓	iuyv
欻	iwrv
踹	iyeg
揣	iyfg
搋	iyfw
啜	iyoa
穿	irnr
传	irvs
船	irno
川	irgj
串	irfi
氚	irkg
喘	irog
钏	irzg
舛	irdf
椽	irmq
遄	irez
床	idjm
创	idvg
窗	idna
闯	idns
疮	idjl
怆	idll
幢	idei
噇	idoi
吹	ivov
锤	ivzi
捶	ivfi
垂	ivij
炊	ivrv
槌	ivmz
圌	ivqg
棰	ivmi
倕	ivvi
陲	ivpi
纯	ipwl
蠢	iprc
春	iprb
唇	ipjo
醇	ipsz
椿	ipmb
淳	ipdz
蝽	ipcb
鹑	ipis
莼	iphl
瑃	ipib
䲠	ipub
堾	ipyb
𬭚	ipzz
戳	ioes
啜	iooa
辍	iola
绰	iowx
龊	ioye
踔	ioex
逴	iolz
惙	iola
次	cidv
此	ciyl
词	ciio
刺	cimg
赐	cirg
磁	cipw
茨	cihv
呲	ciol
辞	cijx
雌	ciyi
瓷	cida
祠	cito
慈	ciku
泚	cidl
疵	cijl
伺	civo
玼	ciil
糍	cigw
跐	ciel
差	ciyi
茈	cihl
兹	cikw
佽	civv
鹚	ciks
莿	cihg
𫚖	ciyu
从	csvv
葱	cshu
聪	csbu
丛	csvh
琮	csig
悰	cslg
骢	cssu
枞	csmv
璁	csiu
淙	csdg
熜	csru
匆	cshh
囱	csja
苁	cshv
凑	cbdr
腠	cbnr
辏	cblr
粗	cugb
醋	cusb
促	cuve
簇	cukr
蹙	cuse
蹴	cued
猝	cuqx
殂	cuhb
徂	cuvb
卒	cuix
蔟	cuhr
窜	crnf
蹿	cref
汆	crvx
篡	crku
爨	crxr
攒	crfr
撺	crff
镩	crzf
催	cvvi
崔	cvei
脆	cvnl
翠	cvex
啐	cvox
萃	cvhx
摧	cvfi
淬	cvdx
粹	cvgx
毳	cvll
璀	cvii
悴	cvlx
瘁	cvjx
漼	cvdi
缞	cvwk
榱	cvmk
寸	cpxd
存	cpxz
村	cpmd
邨	cplw
皴	cpua
忖	cpld
错	cozb
搓	cofi
挫	cofy
措	cofb
锉	cozy
厝	cojb
撮	cofa
蹉	coei
矬	covy
痤	cojy
瑳	coii
嵯	coei
鹾	coli
磋	copi
脞	cony
棤	comb
莝	cohy
大	darh
打	daft
答	dako
达	darz
搭	dafo
哒	daoz
嗒	daoo
妲	daah
鞑	dahz
怛	dalh
沓	daib
炟	darh
跶	daez
笪	dakh
耷	darb
靼	dahh
垯	dayz
溚	dado
瘩	dajo
褡	dato
荙	dahz
鿎	dapz
𨱏	dazo
𫟼	dazz
带	dlhe
代	dlvs
待	dlvd
呆	dlom
戴	dlxg
贷	dlvr
袋	dlvk
黛	dlvd
逮	dlfz
岱	dlve
殆	dlho
迨	dluz
呔	dlod
歹	dlhd
玳	dlis
傣	dlvx
怠	dluu
绐	dlwo
埭	dlyx
大	dlrh
轪	dllr
骀	dlso
叇	dlgz
垈	dlvy
但	djvh
单	djgt
蛋	djtc
弹	djwt
淡	djdr
丹	djnj
氮	djkr
胆	djnh
担	djfh
旦	djbh
啖	djor
掸	djft
澹	djdi
亶	djih
石	djph
诞	djiz
惮	djlt
耽	djbw
儋	djvi
聃	djbn
殚	djht
疍	djth
箪	djkt
憺	djli
膻	djnh
瘅	djjt
眈	djbw
萏	djhu
赕	djrr
郸	djgp
疸	djjh
𫢸	djvt
𬘘	djww
当	dhge
党	dhgw
档	dhme
挡	dhfe
裆	dhte
荡	dhhg
铛	dhze
宕	dhnp
砀	dhpg
凼	dhiu
珰	dhie
谠	dhiw
菪	dhhp
垱	dhye
筜	dhke
𣗋	dhmw
𬍡	dhdd
到	dkhg
道	dkkz
刀	dkhz
倒	dkvg
岛	dkse
导	dkld
盗	dkdq
叨	dkoh
氘	dkkg
稻	dkuu
捣	dkfe
悼	dklx
纛	dkyg
蹈	dkeu
祷	dktd
捯	dkfg
忉	dklh
帱	dked
舠	dknh
鱽	dkuh
的	dejd
得	devd
地	deyl
德	devu
锝	dezd
嘚	deod
得	dzvd
嘚	dzod
扽	dffl
等	dgkd
灯	dgrt
登	dgxk
邓	dgaw
蹬	dgek
凳	dgxw
瞪	dgbk
噔	dgok
镫	dgzk
戥	dgbs
磴	dgpk
嶝	dgek
澄	dgdk
璒	dgik
地	diyl
第	dikj
低	divd
滴	dido
底	dijd
帝	diie
迪	diyz
敌	dija
蒂	dihe
抵	difd
笛	diky
递	digz
狄	diqr
弟	digj
镝	dizo
氐	dijd
嫡	diao
堤	diyv
骶	dind
棣	dimx
邸	dijp
的	dijd
碲	dipe
嘀	dioo
睇	dibj
禘	dite
谛	diie
籴	divm
砥	dipd
鞮	dihv
涤	didm
荻	dihr
菂	dihd
娣	diaj
诋	diid
觌	dixw
羝	diyd
柢	dimd
翟	diei
杕	dimr
髢	difl
坻	diyd
茋	dihd
缔	diwe
踶	diev
媂	diae
提	difv
蹢	dieo
玓	diid
䃅	dipt
䗖	dice
𤧛	diie
𬱖	diyr
嗲	dwod
点	dmld
店	dmjo
电	dmli
垫	dmfy
碘	dmpg
殿	dmpa
颠	dmxr
典	dmsg
滇	dmdg
甸	dmhq
掂	dmfo
簟	dmkx
癫	dmjr
巅	dmer
奠	dmgr
靛	dmyv
钿	dmzq
踮	dmeo
佃	dmvq
淀	dmdv
玷	dmio
惦	dmlo
坫	dmyo
癜	dmja
扂	dmdo
阽	dmpo
琔	dmiv
掉	dcfx
调	dcio
吊	dcoe
屌	dcpe
叼	dcoz
钓	dczd
雕	dcni
刁	dczh
貂	dcqo
凋	dcdo
鲷	dcuo
碉	dcpo
铫	dczx
窎	dcns
铞	dcze
汈	dcdz
跌	dxer
爹	dxgd
叠	dxab
碟	dxpm
蝶	dxcm
迭	dxjz
谍	dxim
牒	dxkm
昳	dxbr
鲽	dxum
喋	dxom
堞	dxym
瓞	dxjr
耋	dxjy
垤	dxyy
绖	dxwy
楪	dxmm
蹀	dxem
𫶇	dxee
定	dynv
顶	dytr
丁	dyth
盯	dybt
订	dyit
钉	dyzt
鼎	dybx
叮	dyot
碇	dypv
町	dyqt
腚	dynv
锭	dyzv
玎	dyit
啶	dyov
酊	dyst
仃	dyvt
疔	dyjt
耵	dybt
萣	dyhv
丢	dqju
铥	dqzu
懂	dsli
动	dsgx
东	dslh
洞	dsdo
冻	dsdl
冬	dsag
董	dshi
栋	dsml
咚	dsog
氡	dskg
侗	dsvo
鸫	dsls
胴	dsno
峒	dseo
恫	dslo
硐	dspo
岽	dsel
垌	dsyo
胨	dsnl
𬟽	dscl
都	dbjp
斗	dbgx
抖	dbfx
豆	dbhk
逗	dbhz
兜	dbjw
痘	dbjk
陡	dbpe
窦	dbnr
读	dbir
蔸	dbhw
蚪	dbcx
钭	dbzx
篼	dbkw
读	duir
度	duja
都	dujp
赌	durb
毒	duyq
堵	duyb
杜	dumy
独	duqc
渡	duda
督	duyb
肚	duny
镀	duza
笃	duks
嘟	duop
蠹	dufc
睹	dubb
妒	duap
犊	dufr
渎	dudr
椟	dumr
牍	dukr
阇	dunb
厾	duzu
芏	duhy
黩	duir
髑	dunc
𬭊	duzy
端	drig
段	drfa
短	drvk
断	drgt
椴	drma
锻	drza
缎	drwa
耑	dreg
煅	drra
塅	drya
簖	drkt
瑖	dria
对	dvad
队	dvpv
怼	dvau
堆	dvyi
兑	dvgw
碓	dvpi
祋	dvta
㨃	dvfz
吨	dpol
蹲	dped
盾	dpjb
炖	dprl
顿	dplr
惇	dplz
墩	dpya
遁	dpjz
钝	dpzl
敦	dpia
趸	dphe
囤	dpql
盹	dpbl
沌	dpdl
镦	dpza
礅	dppa
蹾	dpea
砘	dppl
多	dodd
躲	dorm
夺	dord
剁	dowg
朵	dowm
堕	dopy
度	doja
舵	donl
跺	doem
铎	dozf
哆	dood
踱	doea
惰	doln
垛	doym
咄	doou
掇	dofa
埵	doyi
亸	doit
驮	dosr
哚	doom
剟	doag
裰	dota
饳	doku
㙍	doya
额	eenr
恶	eehu
呃	eeol
俄	eevs
饿	eeks
鹅	eess
厄	eejl
讹	eeil
鳄	eeus
鄂	eeop
娥	eeas
欸	eeuv
蛾	eecs
颚	eeor
腭	eens
锇	eezs
扼	eefl
阿	eepo
轭	eell
莪	eehs
遏	eebz
谔	eeis
屙	eepo
萼	eehs
锷	eezs
鹗	eeos
愕	eels
峨	eees
涐	eeds
垩	eehy
崿	eees
噩	eeio
哦	eeos
婀	eeao
姶	eeao
苊	eehl
堨	eeyl
𥔲	eeps
𫫇	eeou
诶	eiir
欸	eiuv
嗯	enou
恩	enqu
摁	enfu
蒽	enhu
嗯	egou
而	ertg
二	ergh
儿	erwl
耳	erbh
尔	erhg
贰	ersr
饵	erkb
迩	erhz
铒	erzb
珥	erib
鸸	erts
洱	erdb
鲕	erug
耏	ertg
陑	erpg
咡	erob
发	faxd
法	fadu
伐	favs
罚	faqg
阀	fans
乏	fajz
筏	faks
珐	faiu
垡	favy
砝	fapu
反	fjja
饭	fjka
翻	fjue
犯	fjql
范	fjhl
泛	fjdz
凡	fjwd
番	fjuq
烦	fjrr
返	fjja
帆	fjed
藩	fjhq
繁	fjvg
梵	fjmd
樊	fjmr
蕃	fjhq
贩	fjra
钒	fjzd
矾	fjpd
幡	fjeq
燔	fjrq
氾	fjdl
蘩	fjhg
璠	fjiq
蹯	fjeq
畈	fjqa
墦	fjyq
𫔍	fjzq
𬸪	fjus
放	fhia
方	fhih
防	fhph
房	fhdh
仿	fhvh
坊	fhyh
芳	fhhh
访	fhih
钫	fhzh
昉	fhbh
纺	fhwh
枋	fhmh
鲂	fhuh
妨	fhah
肪	fhnh
舫	fhnh
蚄	fhch
邡	fhip
牥	fhfh
非	fzxi
费	fzsr
飞	fzzg
肺	fznf
废	fzjd
肥	fznl
菲	fzhx
妃	fzal
匪	fzcx
绯	fzwx
斐	fzxx
吠	fzod
沸	fzds
啡	fzox
霏	fztx
榧	fzmx
扉	fzdx
腓	fznx
淝	fzdl
蜚	fzxc
朏	fznu
镄	fzzr
诽	fzix
痱	fzjx
翡	fzxe
狒	fzqs
鲱	fzux
悱	fzlx
芾	fzhf
棐	fzxm
剕	fzxg
篚	fzkx
𬴂	fzsx
分	ffgh
粉	ffgh
份	ffvh
坟	ffyx
芬	ffhh
粪	ffgg
焚	ffmr
汾	ffdh
酚	ffsh
忿	ffgu
愤	fflr
奋	ffrq
偾	ffvr
纷	ffwh
氛	ffkh
棻	ffhm
棼	ffmh
鲼	ffur
瀵	ffdg
玢	ffih
翂	ffeh
吩	ffoh
坋	ffyh
鼢	ffuh
豮	ffqr
𣸣	ffdr
风	fgwx
封	fgyd
冯	fgds
峰	fgef
疯	fgjx
缝	fgwz
奉	fgrf
逢	fgaz
锋	fgzf
丰	fgfh
凤	fgwa
枫	fgmx
蜂	fgcf
俸	fgvf
沣	fgdf
讽	fgix
葑	fghd
沨	fgdx
烽	fgrf
酆	fgep
唪	fgof
砜	fgpx
崶	fged
赗	fgrb
浲	fgdf
佛	fovs
否	fbto
缶	fbvu
负	fuhr
附	fupd
服	funa
副	fuhg
付	fuvd
福	futq
府	fujd
复	fuva
富	funq
夫	furh
赴	fuel
父	fugx
扶	fufr
氟	fuks
赋	fury
弗	fusz
符	fukd
伏	fuvd
傅	fuvd
幅	fueq
敷	fufa
芙	fuhr
斧	fugt
釜	fugk
腹	funa
浮	fudz
辅	fulf
妇	fuae
甫	fufd
覆	fusa
抚	fufw
拂	fufs
腐	fujv
缚	fuwd
俘	fuvz
俯	fuvd
腑	fund
辐	fulq
孚	fujz
孵	fucz
佛	fuvs
阜	fujx
凫	fusw
肤	funr
蝠	fucq
祓	futd
脯	funf
芣	fuht
黼	fuxd
鄜	fujw
馥	fuua
涪	fudo
桴	fumz
黻	fuxd
苻	fuhd
拊	fufd
麸	fuyr
郛	fujp
玞	fuir
簠	fukq
绂	fuwd
宓	funu
跗	fued
茯	fuhd
赙	furd
莩	fuhz
趺	fuer
茀	fuhs
蝮	fuca
稃	fuuz
匐	fuhq
罘	fuqt
驸	fusd
怫	fuls
呋	fuor
袱	futd
洑	fudd
榑	fumd
鲋	fuud
菔	fuha
滏	fudk
芾	fuhf
咐	fuod
幞	fuen
艴	fusl
绋	fuws
蚨	fucr
韨	fufd
琈	fuiz
垺	fuyz
讣	fuil
蜉	fucz
砆	fupr
㕮	fuox
㳇	fudx
𫓧	fuzr
𫖯	fuxr
尬	gawg
嘎	gaos
噶	gaol
伽	gavo
尕	gahg
钆	gazl
咖	gaoo
旮	gaxb
尜	gagg
轧	gall
戛	gats
该	gliv
改	glla
盖	glyq
钙	glzl
概	glmw
丐	gltl
垓	glyv
陔	glpv
溉	gldw
赅	glrv
荄	glhv
戤	glhs
晐	glbv
𬮿	glpl
感	gjsu
干	gjth
敢	gjza
肝	gjnt
杆	gjmt
赶	gjet
甘	gjbh
柑	gjmb
淦	gjdz
赣	gjir
苷	gjhb
擀	gjft
绀	gjwb
竿	gjkt
尴	gjwq
橄	gjma
秆	gjut
酐	gjst
鳡	gjuu
玕	gjit
矸	gjpt
泔	gjdb
坩	gjyb
旰	gjbt
疳	gjjb
澉	gjda
虷	gjct
㽏	gjdb
刚	ghng
岗	ghex
港	ghdl
杠	ghmi
缸	ghvi
钢	ghzx
纲	ghwx
肛	ghni
冈	ghnx
罡	ghqi
矼	ghpi
扛	ghfi
戆	ghiu
冮	ghdi
堽	ghyi
筻	ghkr
㭎	ghmx
鿍	ghyf
高	gkio
搞	gkfo
稿	gkuo
告	gkfo
膏	gkin
糕	gkgd
镐	gkzo
诰	gkio
皋	gkjx
锆	gkzo
郜	gkfp
缟	gkwo
睾	gkjy
藁	gkhm
杲	gkbm
篙	gkko
槔	gkmx
羔	gkyd
槁	gkmo
筶	gkko
个	gevi
各	geao
哥	geto
歌	getv
格	gemo
割	geng
隔	gepy
咯	geoo
搁	gefo
戈	gesh
葛	gehl
阁	geno
铬	gezo
鸽	gevs
镉	gezy
革	gehf
嗝	geoy
硌	gepo
膈	geny
鬲	gehy
胳	geno
蛤	geco
骼	geno
盖	geyq
舸	geno
圪	geyz
疙	gejz
饹	geko
滆	gedy
袼	geto
哿	gexo
仡	gevz
合	gevo
虼	gecz
塥	geyy
给	gzwo
跟	gfek
根	gfmk
哏	gfok
艮	gfpk
亘	gfhh
茛	gfhk
更	gghr
梗	ggmr
羹	ggyr
耿	ggbr
耕	ggms
庚	ggjr
埂	ggyr
哽	ggor
赓	ggjr
暅	ggbh
鲠	ggur
浭	ggdr
颈	ggzr
绠	ggwr
鹒	ggjs
𬒔	ggpn
共	gssg
供	gsvg
弓	gswz
工	gsih
公	gsgu
宫	gsno
攻	gsia
功	gsix
拱	gsfg
龚	gswg
汞	gsix
贡	gsir
恭	gssl
巩	gsid
躬	gsrw
肱	gsnu
觥	gshw
蚣	gscu
珙	gsig
䢼	gssp
硔	gspg
狗	gbqo
够	gbhd
勾	gbhu
钩	gbzu
购	gbru
沟	gbdu
苟	gbho
构	gbmu
垢	gbyo
篝	gbkn
遘	gbsz
彀	gbya
诟	gbio
觏	gbsw
媾	gban
枸	gbmo
姤	gbao
雊	gbhi
鞲	gbhn
句	gbho
笱	gbko
缑	gbwr
佝	gbvo
岣	gbeo
耇	gbjo
故	guxa
股	guna
古	guxo
鼓	guya
谷	gugo
骨	guni
顾	gujr
钴	guzo
雇	gudi
孤	guzj
固	guqo
菇	guho
姑	guao
蛊	gucq
箍	guke
估	guvo
咕	guoo
瞽	guyb
沽	gudo
菰	guhj
诂	guio
辜	guxx
毂	guya
榖	guya
觚	guhj
贾	gusr
酤	guso
锢	guzo
崮	gueo
堌	guyo
蛄	guco
罟	guqo
汩	gudb
鹘	guns
轱	gulo
牯	gufo
嘏	guxa
梏	gumo
鲴	guuo
呱	guoj
鹄	gufs
痼	gujo
鸪	guxs
羖	guya
瀔	guda
臌	guna
馉	gukn
牿	gufo
蓇	guhn
𦙶	guno
挂	gwfy
刮	gwjg
瓜	gwjj
卦	gwyl
寡	gwnh
呱	gwoj
剐	gwog
胍	gwnj
褂	gwtl
栝	gwmo
鸹	gwjs
诖	gwiy
怪	gyly
乖	gyjx
拐	gyfx
夬	gyrz
掴	gyfd
管	grkb
关	grkr
官	grnb
观	graw
馆	grkb
冠	grnd
灌	grdi
罐	grvi
棺	grmb
贯	grqr
惯	grlr
毌	grql
倌	grvb
掼	grfr
瓘	grii
祼	grtm
鹳	grhs
琯	grib
鳏	grux
筦	grkw
爟	grri
盥	grxq
涫	grdb
纶	grwl
莞	grhw
鳤	grub
蒄	grhd
光	gdgw
广	gdjd
逛	gdqz
咣	gdow
洸	gddw
桄	gdmw
犷	gdqj
胱	gdnw
垙	gdyw
珖	gdiw
𨐈	gdlw
贵	gvyr
归	gvge
鬼	gvwj
柜	gvmc
跪	gvel
轨	gvlx
硅	gvpy
龟	gvhl
桂	gvmy
圭	gvyy
规	gvrw
诡	gvil
瑰	gviw
珪	gviy
簋	gvkq
癸	gvxr
妫	gvad
邽	gvyp
鲑	gvuy
刿	gveg
晷	gvbo
闺	gvny
桧	gvmu
刽	gvvg
鳜	gvuv
鬶	gvry
宄	gvnx
庋	gvja
匦	gvcx
皈	gvja
炅	gvbr
姽	gval
筀	gvky
滚	gpdk
棍	gpml
鲧	gpug
辊	gpll
衮	gpik
绲	gpwl
磙	gppk
过	goxz
国	goqd
锅	gozn
郭	goip
果	gomi
裹	goik
粿	gogm
虢	gojw
椁	gomz
馘	gokh
腘	gond
掴	gofd
馃	gokm
崞	goez
呙	goon
帼	goed
蝈	gocd
聒	gobo
蜾	gocm
涡	godn
埚	goyn
𬇹	godd
哈	haoo
蛤	haco
铪	hazo
还	hltz
海	hldq
嗨	hloq
害	hlno
氦	hlkv
孩	hlzv
亥	hliv
嗐	hloo
醢	hlsq
骇	hlsv
骸	hlnv
咳	hlov
咍	hloo
胲	hlnv
含	hjvo
喊	hjoo
汉	hjda
韩	hjxf
汗	hjdt
寒	hjng
邯	hjbw
函	hjwu
憨	hjzu
焊	hjrt
旱	hjbt
焓	hjro
悍	hjlt
罕	hjnt
涵	hjdu
翰	hjxe
憾	hjlu
酣	hjsb
撼	hjfu
瀚	hjde
颔	hjvr
晗	hjbo
捍	hjft
蚶	hjcb
鼾	hjjt
扞	hjft
菡	hjhu
邗	hjtw
琀	hjio
暵	hjbr
犴	hjqt
顸	hjtr
撖	hjfa
浛	hjdo
虷	hjct
㘎	hjoa
垾	hjyt
崡	hjeu
嵅	hjeo
蔊	hjht
行	hhvt
杭	hhmw
航	hhnw
夯	hhrx
沆	hhdw
颃	hhir
绗	hhwt
巷	hhsl
吭	hhow
好	hkaz
号	hkos
薅	hkhd
耗	hkml
浩	hkdo
豪	hkiq
壕	hkyq
嚎	hkoq
郝	hkyp
蚝	hkcl
皓	hkjo
蒿	hkho
毫	hkil
昊	hkbr
皞	hkjx
濠	hkdq
灏	hkdr
貉	hkqo
鄗	hkip
淏	hkdr
嗥	hkox
颢	hkbr
镐	hkzo
嚆	hkoo
和	heuo
喝	heol
核	hemv
盒	hevq
何	hevo
合	hevo
河	hedo
呵	heoo
贺	hexr
鹤	hees
赫	heyx
荷	heho
禾	heuj
阖	henq
龁	heyz
嗬	heoo
褐	hetl
曷	hebl
颌	hevr
郃	hevp
盍	heyq
涸	hedo
诃	heio
鹖	hebs
劾	heix
貉	heqo
纥	hewz
盉	heuq
壑	hely
吓	heot
龢	hevu
熇	hero
菏	heho
饸	heko
翮	hehe
翯	heeo
阂	henv
垎	heyo
隺	heei
鞨	hehl
𬌗	hero
黑	hzid
嘿	hzod
𬭶	hzzd
很	hfvk
恨	hflk
狠	hfqk
痕	hfjk
𬣳	hfik
哼	hgow
横	hgmg
恒	hglh
衡	hgvt
亨	hgiw
珩	hgit
桁	hgmt
蘅	hght
鸻	hgvs
姮	hgah
行	hgvt
堼	hgyy
红	hswi
烘	hsrg
宏	hsnu
哄	hsog
轰	hsla
虹	hsci
洪	hsdg
鸿	hsds
薨	hshl
弘	hswu
泓	hsdu
纮	hswu
闳	hsnu
吽	hsof
竑	hsiu
黉	hsgg
翃	hsxe
訇	hshi
蕻	hshg
唝	hsor
讧	hsii
荭	hshi
玒	hsii
谼	hsgg
𫟹	hszg
𬭎	hszu
后	hbjo
厚	hbjz
吼	hbol
侯	hbvr
猴	hbqr
候	hbvr
喉	hbor
齁	hbjo
鲎	hbgu
堠	hbyr
垕	hbjy
逅	hbjz
糇	hbgr
瘊	hbjr
骺	hbno
篌	hbkr
郈	hbjp
鲘	hbuo
𬭤	hbzr
壶	huyh
户	hudp
湖	hudn
胡	huxn
虎	hujw
乎	hujx
糊	hugn
和	huuo
互	huho
呼	huox
护	hufp
沪	hudp
忽	huhu
弧	huwj
狐	huqj
唬	huow
核	humv
斛	huhx
瑚	huin
瓠	hurj
縠	huya
笏	hukg
鹄	hufs
鄠	hutp
葫	huhn
煳	hurn
扈	hudl
烀	hurx
祜	huto
怙	hulo
惚	hulu
觳	huya
鹘	huns
岵	hueo
唿	huou
冱	hudh
鹱	husa
鳠	huua
蝴	hucn
琥	huiw
淴	hudu
浒	hudx
鹕	huxs
醐	husn
槲	humx
滹	hudx
囫	huqg
戽	hudx
嫭	huax
轷	hulx
猢	huqn
昈	hubp
昒	hubg
花	hwhl
化	hwvl
画	hwhu
话	hwio
滑	hwdn
华	hwvx
划	hwsg
哗	hwox
桦	hwmx
婳	hwau
骅	hwsx
猾	hwqn
砉	hwfp
铧	hwzx
觟	hwhy
坏	hyyt
怀	hylt
淮	hydi
踝	hyem
槐	hymw
徊	hyvo
换	hrfr
还	hrtz
环	hrit
患	hrfu
幻	hrwz
缓	hrwa
欢	hrav
唤	hror
嬛	hrak
桓	hrmh
寰	hrnk
浣	hrdw
焕	hrrr
獾	hrqi
涣	hrdr
洹	hrdh
圜	hrqk
豢	hrgq
郇	hrhp
鲩	hruw
奂	hrhr
宦	hrnc
萑	hrhi
逭	hrnz
擐	hrfk
缳	hrwk
鹮	hrqs
澴	hrdk
镮	hrzk
漶	hrdu
鬟	hrfk
睆	hrbw
痪	hrjr
貆	hrqh
峘	hreh
锾	hrza
㬊	hrba
荁	hrhh
𤩽	hrid
𬘫	hrww
黄	hdsg
慌	hdlg
皇	hdji
晃	hdbw
荒	hdhg
谎	hdig
簧	hdkg
煌	hdri
篁	hdki
凰	hdwi
幌	hdew
蝗	hdci
恍	hdlw
滉	hddw
遑	hdjz
潢	hddg
璜	hdig
湟	hddi
磺	hdpg
肓	hdin
锽	hdzi
徨	hdvi
惶	hdli
鳇	hdui
隍	hdpi
喤	hdoi
艎	hdni
癀	hdjg
蟥	hdcg
媓	hdai
瑝	hdii
㿠	hdjw
𨱑	hdzg
会	hvvu
回	hvqo
灰	hvxr
毁	hvua
汇	hvdc
惠	hvcu
茴	hvho
绘	hvwu
挥	hvfl
辉	hvgl
悔	hvlq
慧	hvfu
喙	hvoq
晖	hvbl
烩	hvru
讳	hvif
恢	hvlr
徽	hvva
卉	hvxh
虺	hvhc
蕙	hvhu
秽	hvud
麾	hvjl
晦	hvbq
诲	hviq
隳	hvpl
恚	hvyu
荟	hvhu
浍	hvdu
洄	hvdo
翚	hvel
贿	hvrn
翙	hvee
咴	hvor
珲	hvil
蛔	hvco
彗	hvfe
哕	hvod
诙	hvir
袆	hvtf
橞	hvmu
蟪	hvcu
桧	hvmu
溃	hvdr
烠	hvrn
硊	hvpl
㧑	hvfd
𬤝	hviu
𬭬	hvze
混	hpdl
魂	hpgw
婚	hpab
荤	hphl
浑	hpdl
昏	hpjb
溷	hpdq
珲	hpil
阍	hpnb
馄	hpkl
诨	hpil
惛	hplb
碈	hppb
或	hosh
活	hodo
火	hord
货	hovr
获	hohd
霍	hoti
嚯	hooi
祸	hotn
豁	hono
伙	hovr
和	houo
惑	hosu
镬	hoza
藿	hohi
钬	hozr
濩	hoda
夥	homd
嚄	hooa
蠖	hoca
攉	hofi
漷	hodp
劐	hohg
耠	homo
佸	hovo
锪	hozu
㸌	hori
𬴃	hosp
及	jiaj
即	jipp
级	jiwa
机	jimw
既	jipw
集	jivm
记	jiil
鸡	jias
极	jima
几	jiwj
季	jiuz
肌	jinw
基	jiby
急	jihu
系	jijg
继	jiwl
挤	jifg
计	jiix
剂	jiig
给	jiwo
寄	jino
姬	jiac
技	jifa
祭	jixg
吉	jiyo
寂	jina
籍	jikb
击	jifu
纪	jiwl
忌	jilu
己	jilz
积	jiug
暨	jiph
辑	jilb
脊	jixn
疾	jijr
戟	jixs
箕	jikg
激	jida
济	jidg
矶	jipw
叽	jiow
迹	jiiz
饥	jikw
绩	jiwr
冀	jixg
棘	jimm
藉	jihb
际	jipg
稷	jiua
妓	jiaa
汲	jida
蓟	jihg
伋	jiva
赍	jixr
亟	jiwh
髻	jifo
殛	jihh
鲫	jiup
伎	jiva
稽	jiub
偈	jivl
畸	jiqo
霁	jitg
圾	jiya
嫉	jiar
讥	jiiw
奇	jiro
笈	jika
骥	jisg
嵴	jien
唧	jiop
齑	jiii
乩	jill
戢	jios
玑	jiiw
畿	jiwq
芰	jiha
嵇	jiue
洎	jidb
罽	jiqg
笄	jiks
楫	jimb
羁	jiqs
跻	jieg
麂	jijw
垍	jiyb
姞	jiao
荠	jihg
蕺	jihs
屐	jipa
跽	jieu
觊	jiew
漈	jidg
悸	jilz
缉	jiwb
剞	jirg
鲚	jiug
觭	jiho
佶	jivo
掎	jifo
岌	jiea
惎	jibu
耤	jimb
虮	jicw
芨	jiha
瘠	jijn
期	jibn
蹐	jien
犄	jifo
穄	jiug
堲	jipy
蒺	jihr
墼	jify
瀱	jidg
鹡	jixs
鱾	jiul
㴔	jidu
徛	jivo
枅	jims
𪟝	jiyx
𫌀	jitr
𫓯	jizy
𫓹	jizg
𬯀	jipg
𬶨	jipu
𬶭	jiug
加	jwxo
家	jwnq
假	jwva
价	jwvg
甲	jwti
架	jwxm
夹	jwrg
贾	jwsr
嫁	jwaq
佳	jwvy
钾	jwzt
嘉	jwyo
伽	jwvo
驾	jwxs
痂	jwjo
镓	jwzq
颊	jwrr
荚	jwhg
枷	jwmo
迦	jwxz
葭	jwha
岬	jwet
珈	jwio
斝	jwox
笳	jwko
郏	jwrp
瘕	jwja
铗	jwzg
戛	jwts
稼	jwuq
浃	jwdg
茄	jwho
胛	jwnt
槚	jwmr
跏	jweo
蛱	jwcg
袈	jwxk
恝	jwfu
泇	jwdo
𬂩	jwmg
间	jmnb
见	jmwi
件	jmvf
键	jmzz
剑	jmvg
兼	jmks
建	jmfw
减	jmdo
煎	jmkd
捡	jmfh
箭	jmkg
剪	jmkh
肩	jmdn
简	jmkb
尖	jmgr
舰	jmnw
贱	jmrs
健	jmvz
碱	jmpo
歼	jmhx
茧	jmhc
监	jmgq
荐	jmhz
溅	jmds
渐	jmdt
拣	jmfl
检	jmmh
僭	jmvb
谏	jmim
奸	jmat
坚	jmgy
鉴	jmgz
笺	jmks
涧	jmdb
践	jmes
蹇	jmne
艰	jmak
翦	jmke
菅	jmhb
俭	jmvh
柬	jmmh
缄	jmwo
腱	jmnz
笕	jmkw
缣	jmws
锏	jmzb
睑	jmbh
戋	jmsh
鞬	jmhz
謇	jmni
湔	jmdg
踺	jmez
犍	jmfz
裥	jmtb
槛	jmmq
蒹	jmhs
搛	jmfs
鲣	jmuy
枧	jmmw
戬	jmhs
鹣	jmks
楗	jmmz
暕	jmbm
谫	jmih
毽	jmlz
趼	jmes
篯	jmks
饯	jmks
鞯	jmhz
牮	jmvf
鳒	jmus
𬣡	jmis
将	jdkd
讲	jdis
奖	jdkr
酱	jdks
姜	jdya
江	jddi
降	jdpf
蒋	jdhd
僵	jdvh
匠	jdct
桨	jdkm
浆	jdkx
犟	jdwf
绛	jdwf
疆	jdwh
缰	jdwh
鳉	jdud
豇	jdhi
洚	jddf
强	jdwc
耩	jdmn
弶	jdwg
虹	jdci
糨	jdgc
礓	jdph
茳	jdhi
膙	jdnc
叫	jcou
交	jcix
较	jclx
教	jcja
脚	jcnp
角	jchf
胶	jcnx
浇	jcdw
缴	jcwa
焦	jcvd
搅	jcfw
嚼	jcod
窖	jcno
椒	jcma
娇	jcag
绞	jcwx
跤	jcex
鲛	jcux
轿	jclg
矫	jcvg
剿	jcgg
蛟	jccx
徼	jcva
骄	jcsg
礁	jcpd
饺	jckx
蕉	jchd
铰	jczx
狡	jcqx
皎	jcjx
郊	jcip
湫	jcdr
姣	jcax
酵	jcsz
滘	jcdo
校	jcmx
鹪	jcvs
醮	jcsd
皦	jcja
觉	jcgw
敫	jcja
艽	jchx
茭	jchx
峤	jceg
佼	jcvx
璬	jcia
燋	jcrd
侥	jcvw
斠	jcsx
皭	jcjd
峧	jcex
藠	jchb
噍	jcod
漖	jcda
僬	jcvd
恔	jclx
䴔	jcis
届	jxpy
界	jxqg
接	jxfa
借	jxvb
皆	jxlb
解	jxhf
节	jxhp
姐	jxab
街	jxvt
结	jxwo
截	jxxi
杰	jxmd
劫	jxyx
戒	jxsh
阶	jxpg
揭	jxfl
介	jxvg
蚧	jxcg
洁	jxdo
捷	jxfv
芥	jxhg
藉	jxhb
嗟	jxoi
诘	jxio
羯	jxyl
桀	jxdm
竭	jxil
价	jxvg
桔	jxmo
颉	jxyr
疖	jxjp
孑	jxzz
诫	jxih
婕	jxav
玠	jxig
疥	jxjg
睫	jxbv
碣	jxpl
絜	jxfg
劼	jxyx
秸	jxuo
拮	jxfo
檞	jxmf
骱	jxng
湝	jxdb
楷	jxmb
蜐	jxcx
鲒	jxuo
讦	jxit
喈	jxob
悈	jxlh
褯	jxte
岊	jxle
㛃	jxfa
进	jnsz
近	jnjz
仅	jnva
金	jnzj
斤	jnjt
今	jnvz
尽	jnpg
劲	jnzx
紧	jngg
晋	jnhb
禁	jnmg
筋	jnkx
津	jndf
巾	jnei
锦	jnze
浸	jnda
堇	jnhy
谨	jniy
靳	jnht
槿	jnmy
衿	jntz
瑾	jniy
烬	jnrg
襟	jntg
矜	jnrz
瑨	jnib
噤	jnog
溍	jndb
缙	jnwb
觐	jnhw
祲	jnta
妗	jnaz
馑	jnky
浕	jndg
赆	jnrg
荩	jnhg
殣	jnhy
珒	jnif
廑	jnjy
琎	jniz
墐	jnyy
卺	jnwl
𬬱	jnzt
经	jywi
竟	jyiw
精	jygn
镜	jyzw
净	jydt
静	jyyt
竞	jyiw
景	jybg
井	jysh
敬	jyha
京	jyig
鲸	jyug
惊	jylg
颈	jyzr
警	jyhi
境	jyyw
茎	jyhi
荆	jyhg
径	jyvi
靖	jyin
菁	jyhn
晶	jybb
睛	jybn
璟	jyig
胫	jyni
粳	jygr
阱	jyps
劲	jyzx
旌	jyiy
肼	jyns
泾	jydi
丼	jysd
婧	jyan
竫	jyit
迳	jyzz
儆	jyva
腈	jynn
憬	jylg
痉	jyji
倞	jyvg
刭	jyzg
靓	jyyw
獍	jyqw
兢	jyxw
鼱	jyun
汫	jyds
璥	jyia
麖	jyjg
猄	jyqg
䴖	jyys
囧	jsqi
冏	jsno
炯	jsro
迥	jsnz
窘	jsno
扃	jsdo
颎	jslr
炅	jsbr
坰	jsyo
泂	jsdo
䌹	jswo
𬳶	jsso
就	jqid
酒	jqds
旧	jqib
救	jqxa
九	jqxj
久	jqhn
揪	jqfr
灸	jqhr
鸠	jqxs
啾	jqor
玖	jqin
韭	jqxh
纠	jqwu
舅	jqux
究	jqnx
咎	jqao
臼	jquj
鹫	jqis
厩	jqjw
僦	jqvd
柩	jqmn
疚	jqjn
氿	jqdx
鬏	jqfr
阄	jqnl
赳	jqeu
桕	jqmu
㠇	jqed
据	jufo
剧	jupg
局	jupo
句	juho
举	jugf
距	juec
聚	jubq
巨	juch
居	jupo
具	jubg
拒	jufc
狙	juqb
俱	juvg
菊	juhm
锯	juzo
焗	juro
橘	jumo
车	julh
惧	julg
車	jufh
矩	juvc
钜	juzc
鞠	juhm
遽	jujz
拘	jufo
沮	judb
驹	juso
莒	juho
掬	jufm
踞	jueo
桔	jumo
锔	juzo
苴	juhb
炬	jurc
讵	juic
咀	juob
琚	juio
裾	juto
椐	jumo
鞫	juhi
秬	juuc
屦	jupa
倨	juvo
雎	jubi
娵	juaa
苣	juhc
疽	jujb
榉	jumf
筥	juko
蒟	juho
窭	juna
醵	jusq
飓	juwg
龃	juyb
崌	jueo
柜	jumc
泃	judo
砠	jupb
踽	juec
犋	jufg
岨	jueb
枸	jumo
趄	jueb
澽	judq
岠	juec
腒	juno
弆	juyh
䴗	jubs
𬶋	juuo
卷	jrgl
捐	jrfn
圈	jrql
绢	jrwn
涓	jrdn
娟	jran
倦	jrvl
隽	jrvh
狷	jrqn
镌	jrzh
蠲	jrkc
鹃	jros
鄄	jrsp
眷	jrgb
焆	jrrn
锩	jrzl
桊	jrgm
绝	jtwl
觉	jtgw
嚼	jtod
决	jtdr
撅	jtfv
倔	jtvu
爵	jtjd
掘	jtfu
角	jthf
厥	jtjv
诀	jtir
珏	jtid
玦	jtir
蕨	jthv
蹶	jtev
噘	jtov
崛	jteu
攫	jtfa
谲	jtio
橛	jtmv
抉	jtfr
傕	jtvi
玃	jtqa
爝	jtrd
孓	jtzz
桷	jtmf
觖	jthr
矍	jtba
獗	jtqv
镢	jtzv
劂	jtjg
砄	jtpr
㵐	jtdv
𫔎	jtzo
𫘝	jtsr
均	jpyd
君	jppo
军	jpnl
郡	jppp
菌	jphu
俊	jpva
钧	jpzd
峻	jpea
骏	jpsa
浚	jpda
珺	jpio
畯	jpqa
竣	jpia
麇	jpju
焌	jpra
皲	jpna
晙	jpba
莙	jpho
筠	jpkd
捃	jpfo
龟	jphl
隽	jpvh
葰	jpha
鲪	jpuo
䐃	jpnu
卡	kayl
咯	kaoo
咖	kaoo
咔	kaol
喀	kaoo
胩	kanl
开	klsh
凯	klew
铠	klzl
恺	klll
揩	klfb
楷	klmb
锎	klzs
慨	kllw
闿	klnl
锴	klzb
忾	kllk
垲	klyl
炌	klrg
剀	kleg
蒈	klhb
看	kjjb
砍	kjpv
坎	kjyv
刊	kjtg
堪	kjyl
槛	kjmq
侃	kjvg
勘	kjbx
龛	kjvw
阚	kjna
戡	kjbs
瞰	kjba
莰	kjhv
衎	kjvt
磡	kjpx
崁	kjev
嵁	kjel
墈	kjyx
抗	khfw
扛	khfi
康	khjx
炕	khrw
糠	khgx
钪	khzw
慷	khlx
亢	khiw
伉	khvw
闶	khnw
𡐓	khyx
𩾌	khux
靠	kkfx
考	kkjs
烤	kkrs
拷	kkfs
尻	kkpx
铐	kkzs
犒	kkfo
栲	kkms
洘	kkds
㸆	kkrx
可	keto
课	keim
克	kexw
科	keux
客	keno
氪	kekw
颗	kemr
壳	keyw
磕	kepq
刻	keig
咳	keov
柯	kemo
嗑	keoq
珂	keio
棵	kemm
渴	kedl
恪	kelo
颏	keir
苛	keho
窠	kenm
轲	kelo
髁	kenm
疴	kejo
瞌	kebq
坷	keyo
蝌	kecx
缂	kewf
锞	kezm
骒	kesm
炣	kero
岢	keeo
溘	kedq
稞	keum
匼	keco
牁	keko
剋	kzxg
啃	kfon
肯	kfyn
垦	kfpy
恳	kfpu
裉	kftk
坑	kgyw
吭	kgow
铿	kgzy
硁	kgpi
空	ksni
孔	kszl
控	ksfi
恐	ksiu
崆	ksei
硿	kspi
箜	kski
倥	ksvi
埪	ksyi
口	kboi
扣	kbfo
抠	kbfx
寇	kbna
叩	kbop
蔻	kbha
芤	kbhl
筘	kbko
眍	kbbx
𫸩	kbwx
库	kujl
哭	kuod
苦	kuho
酷	kuso
裤	kutl
枯	kumo
窟	kunu
喾	kugo
刳	kurg
骷	kuno
绔	kuws
矻	kupz
圐	kuqh
跨	kwes
夸	kwrs
垮	kwys
胯	kwns
挎	kwfs
侉	kwvs
姱	kwas
快	kylr
块	kyyr
会	kyvu
筷	kykr
哙	kyou
脍	kynu
郐	kyvp
侩	kyvu
蒯	kyhg
鲙	kyuu
浍	kydu
狯	kyqu
㧟	kyfc
款	kryv
宽	krnw
髋	krnw
狂	kdqi
框	kdmi
矿	kdpj
筐	kdki
况	kddw
哐	kdoi
匡	kdci
旷	kdbj
诓	kdii
邝	kdjw
诳	kdii
眶	kdbi
圹	kdyj
贶	kdrw
纩	kdwj
夼	kdrg
洭	kddi
𫛭	kdqs
亏	kvhs
奎	kvry
窥	kvnw
蝰	kvcy
盔	kvxq
葵	kvhr
夔	kvka
魁	kvwx
匮	kvcr
愧	kvlw
溃	kvdr
揆	kvfr
馈	kvkr
逵	kvyz
愦	kvlr
傀	kvvw
睽	kvbr
櫆	kvmx
馗	kvxb
骙	kvsr
聩	kvbr
跬	kvey
煃	kvry
悝	kvli
戣	kvxs
喟	kvon
喹	kvoy
蒉	kvhr
篑	kvkr
岿	kvee
暌	kvbr
𫠆	kvxr
困	kpqm
坤	kpyf
捆	kpfm
昆	kpbl
鲲	kpul
堃	kpiy
琨	kpil
髡	kpfw
鹍	kpbs
焜	kprl
阃	kpnm
醌	kpsl
悃	kplm
锟	kpzl
壸	kpyh
裈	kptl
婫	kpal
扩	kofj
阔	kono
括	kofo
廓	kojp
蛞	koco
啦	laok
拉	lafk
辣	laim
剌	lamg
蜡	lacb
腊	lanb
喇	laog
菈	lahk
垃	layk
落	laho
邋	lagz
镴	lazg
旯	labx
蝲	lacg
揦	lafg
瘌	lajg
砬	lapk
鞡	lahk
𬶟	laug
来	llmg
莱	llhg
赖	llmr
铼	llzg
濑	lldr
赉	llmr
徕	llvg
癞	lljr
涞	lldg
睐	llbg
崃	lleg
籁	llkr
俫	llvg
梾	llmg
烂	ljrg
蓝	ljhq
懒	ljlr
兰	ljkg
栏	ljmg
揽	ljfw
拦	ljfg
篮	ljkq
岚	ljex
滥	ljdq
览	ljgw
澜	ljdm
榄	ljmw
阑	ljnm
镧	ljzm
缆	ljww
婪	ljma
褴	ljtq
斓	ljim
谰	ljim
罱	ljqy
襕	ljtm
漤	ljda
𬒗	ljpw
狼	lhqk
浪	lhdk
郎	lhdp
朗	lhdn
廊	lhjp
啷	lhop
琅	lhik
烺	lhrk
螂	lhcp
崀	lhek
阆	lhnk
锒	lhzk
榔	lhmp
桹	lhmk
埌	lhyk
塱	lhdy
莨	lhhk
蒗	lhhk
稂	lhuk
筤	lhkk
㫰	lhbk
㮾	lhdm
蓢	lhhn
老	lkjl
捞	lkfx
佬	lkvl
唠	lkox
劳	lkhx
牢	lknf
烙	lkro
铑	lkzl
姥	lkal
涝	lkdx
醪	lksg
酪	lkso
落	lkho
痨	lkjx
铹	lkzx
嫪	lkag
崂	lkex
栳	lkml
荖	lkhl
络	lkwo
耢	lkmx
𫭼	lkyx
了	lewz
乐	lelj
勒	lehx
叻	leox
仂	levx
鳓	leux
簕	lekx
饹	leko
泐	ledx
嘞	leox
类	lzgr
累	lzqg
雷	lztq
泪	lzdb
嘞	lzox
垒	lzuy
勒	lzhx
蕾	lzhq
镭	lzzq
肋	lznx
磊	lzpp
擂	lzfq
罍	lzqu
诔	lzim
羸	lzid
酹	lzsd
耒	lzmh
嫘	lzag
缧	lzwg
儡	lzvq
藟	lzhq
檑	lzmq
礌	lzpq
癗	lzjq
冷	lgdz
楞	lgmh
愣	lglh
棱	lgma
崚	lgea
塄	lgyh
堎	lgya
里	liii
离	liin
力	lixz
李	limz
例	livg
利	liug
理	liii
立	liik
礼	litl
粒	ligk
梨	lium
历	lijx
锂	lizi
丽	lihd
哩	lioi
黎	liux
栗	lism
莉	lihg
吏	lirh
戾	lidd
藜	lihx
鲤	liui
厘	liji
笠	likk
犁	liuf
璃	liin
狸	liqi
厉	lijh
隶	lifx
栎	liml
骊	lisd
荔	lihx
沥	lidx
俪	livd
励	lijx
砾	lipl
醴	lisk
砺	liph
澧	lidk
詈	liqi
鬲	lihy
痢	lijg
罹	liqi
疠	lijh
莅	lihk
俚	livi
郦	lihp
喱	lioi
篱	likn
鳢	liuk
漓	lidn
浬	lidi
轹	lill
俐	livg
蓠	lihn
蛎	lich
蠡	lioc
唳	liod
呖	liox
溧	lidm
蜊	licg
鲡	liud
醨	lisn
嫠	lima
凓	lidm
枥	limx
逦	lihz
娌	liai
粝	ligh
鹂	lihs
苈	lihx
黧	liud
缡	liwn
傈	livm
坜	liyx
疬	lijx
跞	liel
朸	limx
珕	liix
浰	lidg
雳	litx
猁	liqg
篥	likm
㰀	limx
𫵷	liex
𬍛	liij
俩	lwvn
连	lmlz
练	lmwl
脸	lmnh
链	lmzz
联	lmbr
恋	lmiu
莲	lmhz
帘	lmne
炼	lmrl
镰	lmzs
敛	lmva
怜	lmlz
廉	lmjs
涟	lmdz
濂	lmds
殓	lmhh
蠊	lmcs
琏	lmiz
楝	lmmm
鲢	lmuz
奁	lmrx
蔹	lmha
裢	lmtz
潋	lmda
梿	lmmz
浰	lmdg
裣	lmth
瑓	lmim
𬶠	lmum
量	ldbi
两	ldnh
亮	ldiw
梁	lddm
辆	ldln
凉	lddg
粮	ldgk
良	lddk
晾	ldbg
靓	ldyw
俩	ldvn
谅	ldig
粱	lddm
椋	ldmg
俍	ldvk
魉	ldwn
墚	ldym
莨	ldhk
踉	ldek
辌	ldlg
悢	ldlk
𫟅	ldwg
𬜯	ldhn
聊	lcbp
撩	lcfg
料	lcgx
辽	lcwz
廖	lcjg
撂	lcfo
寮	lcng
疗	lcjw
蓼	lchg
瞭	lcbg
钌	lczw
燎	lcrg
了	lcwz
獠	lcqg
潦	lcdg
僚	lcvg
憭	lclg
髎	lcng
寥	lcng
嘹	lcog
橑	lcmg
嫽	lcag
缭	lcwg
镣	lczg
尥	lcwd
蹽	lceg
漻	lcdg
鹩	lcrs
簝	lckg
𪤗	lcyg
列	lxhg
咧	lxog
猎	lxqb
烈	lxhd
裂	lxhk
劣	lxgx
鬣	lxfg
洌	lxdg
冽	lxdg
埒	lxyd
躐	lxeg
捩	lxfd
趔	lxeg
峛	lxeg
脟	lxnd
䴕	lxhs
𫚭	lxug
林	lnmm
拎	lnfz
临	lngq
磷	lnpf
琳	lnim
凛	lndg
淋	lndm
霖	lntm
鳞	lnuf
邻	lnvp
麟	lnjf
璘	lnif
廪	lnjg
赁	lnvr
蔺	lnhi
吝	lnio
檩	lnmg
懔	lnlg
膦	lnnf
潾	lndf
粼	lngg
嶙	lnef
躏	lnei
啉	lnom
遴	lngz
辚	lnlf
箖	lnkm
瞵	lnbf
翷	lnge
𬭸	lnzf
𬴊	lnsf
另	lyox
令	lyvz
零	lytz
领	lyvr
铃	lyzz
灵	lyer
玲	lyiz
岭	lyez
陵	lypa
凌	lyda
龄	lyyz
绫	lywa
翎	lyve
聆	lybz
泠	lydz
澪	lydz
伶	lyvz
蛉	lycz
菱	lyha
苓	lyhz
姈	lyaz
羚	lyyz
呤	lyoz
瓴	lyva
棂	lymr
祾	lyta
鲮	lyua
舲	lynz
棱	lyma
酃	lytp
坽	lyyz
囹	lyqz
柃	lymz
〇	lyoo
鸰	lyvs
昤	lybz
㥄	lyla
六	lqig
留	lqcq
流	lqdg
刘	lqig
溜	lqdq
柳	lqmp
硫	lqpg
遛	lqcz
瘤	lqjq
镠	lqzg
琉	lqig
熘	lqrq
浏	lqdg
绺	lqwo
榴	lqmq
旒	lqig
陆	lqpu
鎏	lqdz
骝	lqsq
馏	lqkq
镏	lqzq
锍	lqzg
珋	lqip
疁	lqqg
罶	lqqq
鹨	lqes
瑬	lqdd
飗	lqwq
碌	lqpx
鹠	lqcs
咯	looo
龙	lswh
隆	lspy
泷	lsdw
拢	lsfw
笼	lskw
陇	lspw
聋	lswb
珑	lsiw
胧	lsnw
垄	lswy
茏	lshw
栊	lsmw
砻	lswp
咙	lsow
哢	lsoh
癃	lsjy
窿	lsny
昽	lsbw
弄	lsih
漋	lsdy
眬	lsbw
𬕂	lskr
楼	lbma
喽	lboa
漏	lbdx
搂	lbfa
娄	lbga
瘘	lbja
露	lbto
篓	lbka
镂	lbza
陋	lbpl
蒌	lbha
耧	lbma
蝼	lbca
偻	lbva
溇	lbda
髅	lbna
嵝	lbea
䁖	lbba
剅	lbhg
𦝼	lbna
𪣻	lbya
路	lueo
录	luex
撸	lufb
陆	lupu
鲁	luub
鹿	lujd
卢	lulp
露	luto
卤	lulx
炉	lurp
虏	lujx
噜	luob
麓	lumj
掳	lufx
禄	lutx
戮	lues
庐	lujp
垆	luyp
橹	lumb
璐	luio
芦	luhp
潞	ludo
颅	lulr
泸	ludp
鹭	lues
胪	lunp
渌	ludx
镥	luzb
赂	luro
鲈	luup
菉	luhx
簏	lukj
蕗	luho
碌	lupx
漉	ludj
僇	luvg
栌	lump
箓	lukx
辂	lulo
舻	lunp
琭	luix
辘	lulj
逯	luez
鸬	luls
甪	lujf
绿	luwx
轳	lulp
勠	luex
澛	ludb
氇	lulb
稑	luuy
𫘧	lusx
𬬻	luzp
乱	lrjl
卵	lrcp
鸾	lris
栾	lrim
銮	lriz
峦	lrie
娈	lria
挛	lrif
脔	lriv
孪	lriz
滦	lrdm
论	lpil
轮	lpll
抡	lpfl
伦	lpvl
仑	lpvl
纶	lpwl
沦	lpdl
囵	lpql
𫭢	lpyl
𬬭	lpzl
罗	loqd
落	loho
咯	looo
洛	lodo
裸	lotm
啰	lood
骆	loso
摞	lofg
螺	locg
络	lowo
骡	losg
锣	lozd
萝	lohd
雒	loai
珞	loio
逻	loqz
蠃	loid
箩	lokd
烙	loro
泺	lodl
荦	lohf
漯	lodg
捋	lofd
倮	lovm
椤	lomd
瘰	lojg
猡	loqd
蓏	lohj
脶	lonn
率	lvix
绿	lvwx
铝	lvzo
吕	lvoo
驴	lvsp
旅	lvik
律	lvvf
捋	lvfd
氯	lvkx
屡	lvpa
滤	lvdu
虑	lvju
履	lvpa
缕	lvwa
侣	lvvo
闾	lvno
膂	lvin
梠	lvmo
榈	lvmo
褛	lvta
偻	lvva
稆	lvuo
葎	lvhf
垏	lvyf
𦝼	lvna
略	ltqo
掠	ltfg
锊	ltzd
圙	ltqq
䂮	ltfp
吗	maos
嘛	maom
骂	maos
马	masl
码	maps
妈	maas
麻	majm
玛	mais
蚂	macs
抹	mafm
蟆	macr
祃	mats
犸	maqs
摩	majf
杩	mams
买	mlzr
卖	mlxr
麦	mlya
埋	mlyi
迈	mlhz
脉	mlnx
霾	mlti
唛	mloa
劢	mlhx
荬	mlhr
鿏	mlza
慢	mjla
满	mjdn
蛮	mjic
曼	mjba
漫	mjda
螨	mjcn
瞒	mjbn
蔓	mjha
幔	mjea
鳗	mjua
缦	mjwa
馒	mjka
谩	mjia
鬘	mjfa
墁	mjya
嫚	mjaa
镘	mjza
颟	mjhr
鞔	mjhw
埋	mjyi
𬜬	mjho
忙	mhll
盲	mhib
莽	mhhh
芒	mhhl
氓	mhis
蟒	mhch
茫	mhhl
邙	mhip
漭	mhdh
尨	mhwh
牻	mhfw
牤	mhfl
厖	mhjw
杧	mhml
硭	mhpl
猫	mkqq
毛	mklj
冒	mknb
帽	mkeb
锚	mkzq
贸	mkcr
矛	mkrz
卯	mkcp
茅	mkhr
貌	mkqw
昴	mkbp
茂	mkhs
冇	mkxn
旄	mkil
峁	mkep
髦	mkfl
铆	mkzp
耄	mkjl
楙	mkmm
懋	mkmu
芼	mkhl
瑁	mkib
牦	mkfl
茆	mkhp
袤	mkik
瞀	mkrb
泖	mkdp
眊	mkbl
鄚	mkhp
蝥	mkrc
蟊	mkrc
么	meju
没	mzda
每	mzvq
美	mzyr
枚	mzma
梅	mzmq
酶	mzsq
妹	mzam
煤	mzrm
霉	mztq
镁	mzzr
眉	mzpb
魅	mzwm
玫	mzia
媚	mzab
昧	mzbm
媒	mzam
莓	mzhq
镅	mzzb
郿	mzpp
寐	mznm
湄	mzdb
浼	mzdw
袂	mztr
楣	mzmb
鹛	mzps
渼	mzdr
瑂	mzib
糜	mzjm
媄	mzar
嵋	mzeb
们	mfvn
门	mfnd
焖	mfru
闷	mfnu
扪	mffn
钔	mfzn
呇	mfio
懑	mfdu
𫞩	mfin
梦	mgmd
猛	mgqq
萌	mghn
蒙	mghq
懵	mglb
孟	mgzq
锰	mgzq
盟	mgbq
濛	mgdq
獴	mgqq
勐	mgzx
虻	mgcl
檬	mgmq
蠓	mgcq
甍	mgha
艋	mgnq
朦	mgnq
瞢	mghb
幪	mgeq
艨	mgnq
蜢	mgcq
礞	mgpq
㠓	mgeq
鹲	mghs
𫑡	mgop
米	migm
迷	migz
密	mine
谜	miiz
蜜	minc
咪	miom
弥	miwg
觅	mijw
幂	mine
蘼	mihx
芈	mixf
秘	miuu
靡	mijx
眯	mibm
糜	mijm
醚	misz
祕	mitu
祢	mitg
弭	miwb
麋	mijm
泌	midu
汨	midb
宓	minu
谧	miiq
脒	minm
蓂	mihg
醾	mism
縻	mijg
猕	miqg
敉	miga
洣	midm
嘧	mioe
面	mmtq
免	mmhw
棉	mmme
眠	mmbs
缅	mmwq
绵	mmwe
勉	mmhx
冕	mmnw
沔	mmdz
眄	mmbz
丏	mmtz
勔	mmtx
愐	mmlq
娩	mmaw
湎	mmdq
腼	mmnq
偭	mmvq
渑	mmdl
𩾃	mmuw
秒	mcuj
喵	mcoq
庙	mcjy
妙	mcaj
瞄	mcbq
苗	mchq
描	mcfq
淼	mcix
渺	mcdj
眇	mcbj
缈	mcwj
杪	mcmj
邈	mcqz
藐	mchw
缪	mcwg
鹋	mchs
灭	mxhr
咩	mxoy
乜	mxll
蔑	mxhd
篾	mxkd
民	mnps
敏	mnva
皿	mnqi
抿	mnfs
闽	mnnc
泯	mnds
闵	mnnx
缗	mnwb
旻	mnbx
愍	mnpu
湣	mndb
珉	mnis
悯	mnlx
岷	mnes
鳘	mnvu
黾	mnol
忞	mniu
苠	mnhs
名	mydo
命	myvp
明	mybn
鸣	myos
茗	myho
冥	myng
铭	myzo
暝	mybg
洺	mydo
溟	mydg
瞑	mybg
酩	myso
螟	mycg
谬	mqig
缪	mqwg
莫	mohr
磨	mojp
魔	mojw
摸	mofr
膜	monr
末	momh
抹	mofm
麽	moju
墨	moiy
没	moda
摩	mojf
默	moid
模	momr
馍	mokr
沫	modm
摹	mohf
殁	moha
陌	mopb
茉	mohm
谟	moir
貘	moqr
漠	modr
貊	moqb
镆	mozr
蘑	mohp
秣	moum
蓦	mohs
寞	monr
万	mohh
瘼	mojr
嬷	moau
耱	momp
无	mohw
脉	monx
嫫	moar
靺	mohm
藦	mohf
𬙊	mowy
某	mbbm
谋	mbim
牟	mbuf
缪	mbwg
眸	mbbf
哞	mbof
侔	mbvf
鍪	mbrz
蛑	mbcf
木	mumh
目	mubi
墓	muhy
姆	muaq
母	muql
穆	muug
沐	mudm
亩	muiq
牧	mufa
暮	muhb
模	mumr
慕	muhl
幕	muhe
钼	muzb
募	muhx
拇	mufq
睦	muby
牡	mufy
呒	muow
苜	muhb
牟	muuf
仫	muvu
毪	mulf
𧿹	mueq
𬭁	muzq
那	nazp
拿	navf
哪	naop
呐	naon
娜	naap
纳	nawn
钠	nazn
捺	nafg
镎	nazf
衲	natn
乸	nalq
南	naxy
肭	nann
𦰡	nahp
乃	nlhw
奶	nlaw
耐	nltd
奈	nlrg
氖	nlkw
萘	nlhg
柰	nlmg
迺	nlsz
艿	nlhw
鼐	nlhx
耏	nltg
佴	nlvb
难	njai
男	njqx
南	njxy
楠	njmy
喃	njoy
腩	njny
囡	njqa
赧	njya
蝻	njcy
婻	njay
萳	njhy
囊	nhfk
馕	nhkk
曩	nhbk
攮	nhfk
齉	nhjk
囔	nhok
脑	nknu
闹	nkne
挠	nkfw
恼	nklu
淖	nkdx
瑙	nkix
孬	nktz
铙	nkzw
垴	nkyu
呶	nkoa
猱	nkqm
臑	nkng
蛲	nkcw
硇	nkpx
峱	nkqe
呢	neol
讷	nein
哪	neop
内	nzni
馁	nzka
嫩	nfaa
恁	nfvu
能	ngul
你	nivg
尼	nipl
逆	nikz
泥	nidl
拟	nifv
匿	nico
腻	ninr
妮	nial
倪	nivw
呢	niol
溺	nidd
铌	nizl
昵	nibl
霓	nitw
睨	nibw
伲	nivl
鲵	niuw
猊	niqw
旎	niil
麑	nijw
坭	niyl
怩	nill
薿	nihv
𨺙	nipw
𫐐	nilw
𫠜	niyw
年	nmvf
念	nmvu
黏	nmuo
碾	nmpk
撵	nmfl
捻	nmfu
辇	nmrl
蔫	nmhd
鲶	nmuu
拈	nmfo
廿	nmhh
鲇	nmuo
埝	nmyu
粘	nmgo
娘	ndak
酿	ndsk
嬢	ndak
鸟	ncsj
尿	ncpx
茑	nchs
脲	ncnx
袅	ncsk
捏	nxfy
镍	nxzm
涅	nxdy
聂	nxba
孽	nxhz
镊	nxza
颞	nxbr
蹑	nxea
臬	nxjm
啮	nxou
蘖	nxhm
嗫	nxoa
乜	nxll
嵲	nxem
菍	nxhu
糵	nxhm
陧	nxpy
𫔶	nxnm
您	nnvu
拧	nyft
宁	nynt
凝	nydv
甯	nynf
狞	nyqt
柠	nymt
苧	nyht
佞	nyva
泞	nydt
咛	nyot
聍	nybt
牛	nqfj
扭	nqfh
妞	nqah
纽	nqwh
钮	nqzh
拗	nqfx
狃	nqqh
杻	nqmh
忸	nqlh
弄	nsih
浓	nsdk
农	nsek
侬	nsvk
脓	nsnk
秾	nsuk
哝	nsok
𬪩	nssk
耨	nbmd
怒	nuau
努	nuax
弩	nuaw
奴	nuaa
驽	nuas
傉	nuvd
孥	nuaz
砮	nuap
胬	nuav
笯	nuka
暖	nrba
诺	noio
挪	nofp
糯	nogg
喏	nooo
傩	novi
懦	nolg
搦	nofd
锘	nozo
娜	noap
𦰡	nohp
女	nval
钕	nvza
衄	nvjh
恧	nvtu
虐	ntje
疟	ntje
哦	ooos
噢	ooor
喔	oooy
欧	oucv
藕	ouhc
偶	ouvc
呕	ouox
区	oucx
鸥	oucs
沤	oudx
殴	ouca
耦	oumc
讴	ouix
瓯	ouca
怄	oulx
𠙶	ouwu
𬉼	ourx
怕	palb
爬	pajl
趴	paeg
啪	paob
帕	paeb
扒	pafg
耙	paml
葩	pahl
琶	pail
杷	paml
舥	panl
潖	padl
筢	pakl
拍	plfb
派	pldk
牌	plkx
排	plfx
湃	pldt
俳	plvx
徘	plvx
哌	plok
迫	pljz
蒎	plhk
簰	plkx
盘	pjnq
判	pjgg
潘	pjdq
畔	pjqf
攀	pjmf
盼	pjbh
叛	pjga
爿	pjkl
磐	pjnp
袢	pjtf
槃	pjnm
蟠	pjcq
泮	pjdf
襻	pjtf
胖	pjnf
番	pjuq
磻	pjpq
蹒	pjen
旁	phih
胖	phnf
庞	phjw
彷	phvh
磅	phph
滂	phdh
乓	phod
逄	phaz
螃	phch
耪	phmh
雱	phth
鳑	phuh
膀	phnh
跑	pkel
泡	pkdl
炮	pkrl
抛	pkfx
刨	pkhg
袍	pktl
匏	pkrl
庖	pkjl
咆	pkol
狍	pkql
疱	pkjl
脬	pknz
配	pzsl
赔	pzro
陪	pzpo
佩	pzvt
呸	pzoh
胚	pznh
裴	pzxk
培	pzyo
醅	pzso
珮	pzit
沛	pzdf
辔	pzwo
旆	pzif
锫	pzzo
帔	pzea
霈	pztf
衃	pzjt
喷	pfor
盆	pfgq
湓	pfdq
捧	pgff
碰	pgph
彭	pgyg
砰	pgpg
棚	pgmn
硼	pgpn
朋	pgnn
鹏	pgns
烹	pgid
嘭	pgog
蓬	pghz
膨	pgng
篷	pgkz
澎	pgdg
芃	pghd
抨	pgfg
椪	pgmh
怦	pglg
弸	pgwn
堋	pgyn
淜	pgdn
蟛	pgcg
搒	pgfh
皮	piaz
屁	pipl
批	pifl
劈	piph
匹	picw
啤	piox
脾	pinx
癖	pijx
披	pifa
辟	pipx
铍	piza
丕	pith
疲	pija
毗	piql
痞	pijo
坯	piyh
嚭	piyo
僻	pivx
罴	piqd
譬	pipi
噼	piox
琵	piil
貔	piql
蜱	picx
圮	piyl
陂	pipa
邳	pitp
郫	pijp
伾	pivh
裨	pitx
霹	pitx
媲	pial
鼙	piyx
陴	pipx
甓	pipa
睥	pibx
埤	piyx
淠	pidk
椑	pimx
狉	piqh
澼	pidx
枇	piml
砒	pipl
蚍	picl
纰	piwl
仳	pivl
否	pito
鲏	piua
䴙	pips
苉	pihw
𬳵	pish
篇	pmkh
偏	pmvh
片	pmkj
骗	pmsh
骈	pmsh
便	pmvr
谝	pmih
翩	pmde
楩	pmmr
扁	pmdh
胼	pmnh
蹁	pmeh
犏	pmfh
㛹	pmar
𡎚	pmyh
票	pcsg
飘	pcsx
漂	pcdg
嫖	pcag
瞟	pcbg
瓢	pcsj
剽	pcsg
缥	pcwg
骠	pcsg
朴	pcml
殍	pchz
薸	pchg
嘌	pcog
蔈	pchg
螵	pccg
撇	pxfa
瞥	pxgb
氕	pxkj
苤	pxhh
𬭯	pxza
拼	pnfh
品	pnoo
频	pnyr
贫	pngr
聘	pnbs
嫔	pnag
颦	pnyx
牝	pnfl
姘	pnah
玭	pnil
𬞟	pnhr
屏	pyph
平	pytg
凭	pyvw
瓶	pyka
评	pyig
坪	pyyg
萍	pyhg
枰	pymg
乒	pyoj
苹	pyhg
娉	pyas
鲆	pyug
俜	pyvs
冯	pyds
洴	pydh
泙	pydg
玶	pyig
涄	pyds
帡	pyeh
荓	pyhh
蚲	pycg
破	popa
颇	poar
坡	poya
泼	podd
婆	poda
迫	pojz
珀	poib
钋	pozl
魄	pojw
钷	pozo
泊	podb
粕	pogb
鄱	poup
皤	pojq
叵	poco
酦	posd
陂	popa
桲	pomz
朴	poml
繁	povg
笸	poko
䥽	pozd
剖	pbig
裒	pbik
掊	pbfo
抔	pbft
谱	puib
铺	puzf
普	pukb
扑	pufl
噗	puon
朴	puml
葡	puhd
蒲	puhd
璞	puin
仆	puvl
浦	pudf
濮	pudn
莆	puhf
溥	pudd
瀑	pudx
圃	puqf
蹼	puen
曝	pubx
埔	puyf
镤	puzn
堡	puvy
镨	puzb
菩	puho
酺	pusf
匍	puhf
蒱	puhd
潽	pudb
脯	punf
墣	puyn
氆	pulb
穙	puun
其	qibg
起	qiel
期	qibn
七	qill
气	qikj
器	qioo
骑	qiso
齐	qiig
棋	qimg
漆	qidx
奇	qiro
弃	qiih
旗	qiig
妻	qiya
绮	qiwo
欺	qibv
岂	qiel
琪	qiig
砌	qiph
启	qido
企	qivy
契	qifr
淇	qidg
泣	qidk
琦	qiio
栖	qims
鳍	qiub
乞	qivz
祁	qitw
戚	qisg
祇	qits
麒	qijg
炁	qiwd
汽	qidk
沏	qidh
柒	qidm
祈	qitt
祺	qitg
讫	qiiz
脐	qing
崎	qieo
岐	qiea
蕲	qiht
迄	qivz
杞	qiml
萁	qihg
嘁	qiog
欹	qirv
锜	qizo
凄	qida
槭	qimg
碛	qipr
畦	qiqy
綦	qibg
歧	qiya
玘	qiil
亓	qihk
耆	qijb
芑	qihl
屺	qiel
埼	qiyo
憩	qiju
跂	qiea
芪	qihs
棨	qidm
葺	qihb
蹊	qier
颀	qijr
骐	qisg
汔	qidz
圻	qiyt
磜	qipg
萋	qiha
蜞	qicg
蛴	qicg
亟	qiwh
愭	qilb
桤	qiml
俟	qivr
荠	qihg
婍	qiao
郪	qiyp
稽	qiub
缉	qiwb
洓	qidm
鲯	qiug
碶	qipr
䓫	qiho
𨙸	qixp
𬨂	qilw
掐	qwfu
恰	qwlo
卡	qwyl
髂	qwno
洽	qwdo
袷	qwto
拤	qwfl
葜	qwhr
前	qmkg
钱	qmzs
千	qmjx
签	qmkh
浅	qmds
欠	qmhv
铅	qmzo
牵	qmrf
遣	qmyz
潜	qmdb
迁	qmjz
乾	qmxz
谦	qmis
嵌	qmev
钳	qmzb
黔	qmiz
茜	qmhs
钤	qmzz
芡	qmhv
歉	qmkv
虔	qmjx
芊	qmhx
倩	qmvn
骞	qmns
仟	qmvx
堑	qmly
搴	qmnf
阡	qmpx
谴	qmiz
汧	qmds
靬	qmht
荨	qmhd
愆	qmvu
佥	qmvh
椠	qmlm
扦	qmfx
褰	qmnk
犍	qmfz
缱	qmwz
慊	qmls
悭	qmly
钎	qmzx
杄	qmmx
鹐	qmhs
蒨	qmhn
岍	qmes
磏	qmps
纤	qmwx
掮	qmfn
墘	qmyz
肷	qmnv
圲	qmyx
伣	qmvw
𬘬	qmwn
强	qdwc
抢	qdfl
枪	qdml
墙	qdyo
腔	qdni
呛	qdol
羌	qdyl
蔷	qdho
炝	qdrl
羟	qdyi
锵	qdzd
戗	qdvs
戕	qdks
锖	qdzn
樯	qdmo
玱	qdil
镪	qdzc
蜣	qdcl
嫱	qdao
襁	qdtc
跄	qdel
蔃	qdhc
敲	qcia
桥	qcmg
乔	qcjg
翘	qcse
瞧	qcbd
巧	qcis
撬	qcfl
壳	qcyw
鞘	qchn
俏	qcvn
樵	qcmd
窍	qcns
谯	qcid
锹	qczr
侨	qcvg
悄	qcln
跷	qcew
荞	qchg
诮	qcin
橇	qcml
峤	qceg
劁	qcvg
峭	qcen
缲	qcwm
硚	qcpg
鞒	qchg
雀	qcgi
憔	qcld
愀	qclr
硗	qcpw
且	qxbi
切	qxlh
妾	qxia
窃	qxnh
怯	qxlu
茄	qxho
箧	qxkg
挈	qxff
伽	qxvo
锲	qxzr
惬	qxlg
郄	qxxp
慊	qxls
趄	qxeb
琴	qniz
秦	qnru
亲	qnim
勤	qnhx
寝	qnna
擒	qnfn
钦	qnzv
沁	qndu
侵	qnva
禽	qnvn
衾	qnvk
噙	qnon
芹	qnht
骎	qnsa
溱	qndu
覃	qnsx
嗪	qnou
芩	qnhz
揿	qnfv
梣	qnmz
慬	qnly
嵚	qnev
螓	qncu
锓	qnza
檎	qnmn
吣	qnou
请	qyin
轻	qyli
清	qydn
氢	qyki
情	qyln
青	qyyn
晴	qybn
卿	qycp
倾	qyvr
庆	qyjr
黥	qyig
磬	qyyp
顷	qylr
擎	qyhf
箐	qykn
氰	qykn
罄	qyyu
蜻	qycn
鲭	qyun
綮	qydg
檠	qyhm
亲	qyim
圊	qyqn
勍	qyix
碃	qypn
庼	qyjr
倩	qyvn
苘	qyho
穷	qsnx
琼	qsig
蛩	qsic
邛	qsiw
穹	qsnw
茕	qshx
銎	qsiz
筇	qskp
䓖	qshx
球	qqid
求	qqxd
秋	qqur
邱	qqow
丘	qqoj
裘	qqxk
糗	qqgd
楸	qqmr
囚	qqqv
逑	qqxz
湫	qqdr
虬	qqcl
璆	qqig
酋	qqgs
仇	qqvx
萩	qqhr
遒	qqgz
鳅	qqur
泅	qqdv
俅	qqvd
鼽	qqjx
赇	qqrd
龟	qqhl
蚯	qqco
蝤	qqcs
鹙	qqus
訄	qqxi
犰	qqqx
巯	qqzg
鞧	qqhs
𨱇	qqzd
去	quyu
区	qucx
取	quba
曲	qusi
娶	quba
屈	qupu
趣	quea
蛆	qucb
龋	quyc
驱	qusx
瞿	qubi
祛	qutu
渠	qudm
趋	quee
躯	qurx
鼩	quuo
觑	qujw
诎	quiu
麹	quym
衢	quvt
蕖	quhm
蘧	quhz
袪	qutu
胠	qunu
朐	quno
劬	quhx
阒	qund
苣	quhc
璩	quiq
癯	quji
鸲	quhs
戌	qush
焌	qura
蠼	quca
氍	qubl
黢	quia
岨	queb
坥	quyb
灈	qudi
岖	quex
蛐	qucs
磲	qupm
竘	quio
㭕	qumu
䓛	quhu
𪨰	ques
𫭟	quyx
全	qrvi
圈	qrql
权	qrma
劝	qrax
券	qrgh
拳	qrgf
犬	qrrd
泉	qrjx
醛	qrsi
蜷	qrcl
荃	qrhi
颧	qrhr
诠	qrii
佺	qrvi
铨	qrzi
鬈	qrfl
痊	qrji
绻	qrwl
筌	qrki
畎	qrqd
悛	qrla
辁	qrli
棬	qrml
瑔	qrix
鳈	qrux
婘	qral
𨟠	qrbp
却	qtyp
缺	qtvr
确	qtpf
卻	qtgp
阙	qtnv
雀	qtgi
瘸	qtjv
鹊	qtss
榷	qtmi
炔	qtrr
阕	qtnr
悫	qtyu
碏	qtpb
埆	qtyf
𬒈	qtgp
群	qppy
裙	qpto
囷	qpqu
麇	qpju
逡	qpuz
然	rjdd
燃	rjrd
染	rjdm
冉	rjni
髯	rjfn
蚺	rjcn
苒	rjhn
䎃	rjne
让	rhiy
穰	rhuk
嚷	rhok
瓤	rhij
攘	rhfk
禳	rhtk
壤	rhyk
瀼	rhdk
儴	rhvk
蘘	rhhk
绕	rkww
饶	rkkw
扰	rkfd
桡	rkmw
娆	rkaw
荛	rkhw
热	refd
惹	rehu
人	rfvj
任	rfvy
认	rfiv
忍	rfhu
仁	rfvg
刃	rfhd
壬	rfjy
韧	rffd
饪	rfky
稔	rfuu
妊	rfay
衽	rfty
纫	rfwd
仞	rfvd
轫	rfld
讱	rfid
纴	rfwy
葚	rfhl
荏	rfhy
仍	rgvw
扔	rgfw
日	ribi
驲	risb
融	rshc
容	rsno
蓉	rsho
荣	rshm
溶	rsdo
戎	rssx
绒	rswx
熔	rsro
冗	rsnw
茸	rshb
榕	rsmo
镕	rszo
嵘	rsem
狨	rsqx
瑢	rsio
蝾	rscm
肉	rbnv
揉	rbfm
柔	rbrm
鞣	rbhm
糅	rbgm
蹂	rbem
𫐓	rblm
如	ruao
入	ruvj
乳	rujl
汝	ruda
儒	ruvg
辱	rujd
濡	rudg
茹	ruho
铷	ruzo
褥	rutd
襦	rutg
蓐	ruhd
孺	ruzg
洳	rudo
蠕	rucg
溽	rudd
缛	ruwd
嬬	ruag
嚅	ruog
薷	ruhg
颥	rutr
挼	rwfa
软	rrlv
阮	rrpw
堧	rryr
瓀	rrig
媆	rrar
瑞	rvig
睿	rvlb
锐	rvzw
蕊	rvhu
芮	rvhn
汭	rvdn
蚋	rvcn
蕤	rvhy
枘	rvmn
润	rpdi
闰	rpni
若	roho
弱	rowd
箬	roko
偌	rovo
爇	rohd
蒻	rohd
鄀	rohp
婼	roao
撒	safa
萨	sahj
仨	savg
洒	sads
飒	saix
卅	sahh
靸	saha
潵	sada
挲	sadf
脎	sanm
赛	slnr
塞	slny
鳃	sluu
腮	slnu
噻	sloy
三	sjgh
散	sjsa
伞	sjvx
叁	sjug
糁	sjgg
毵	sjul
馓	sjka
桑	sham
嗓	shom
丧	shyk
颡	shar
搡	shfm
磉	shpm
扫	skfe
骚	sksc
嫂	skaa
搔	skfc
臊	sknm
埽	skye
缫	skwm
瘙	skjc
溞	skdc
色	sehl
瑟	seiu
涩	sedy
铯	sezl
塞	seny
啬	seyo
穑	seuo
璱	seiu
森	sfmm
僧	sgvb
啥	uaoo
杀	uaxm
傻	uava
沙	uadj
鲨	uadu
莎	uahj
煞	uahd
纱	uawj
砂	uapj
刹	uaxg
痧	uajj
厦	uaja
嗄	uaoa
歃	uajv
霎	uata
铩	uazm
裟	uadk
唼	uaoa
杉	uamg
挲	uadf
晒	ulbs
筛	ulkt
色	ulhl
山	ujei
删	ujhg
闪	ujnv
善	ujyo
扇	ujde
衫	ujtg
擅	ujfh
陕	ujpg
珊	ujih
膳	ujno
杉	ujmg
煽	ujre
膻	ujnh
疝	ujje
骟	ujse
钐	ujzg
赡	ujri
讪	ujie
禅	ujtt
剡	ujrg
缮	ujwo
鳝	ujuo
苫	ujho
鄯	ujyp
芟	ujha
嬗	ujah
埏	ujyz
汕	ujde
晱	ujbr
姗	ujah
潸	ujdn
跚	ujeh
烻	ujrz
蟮	ujco
单	ujgt
栅	ujmh
舢	ujne
墡	ujyo
嶦	ujei
𫮃	ujyt
上	uhyi
商	uhio
伤	uhvx
熵	uhro
尚	uhgo
赏	uhgr
殇	uhhg
裳	uhgk
觞	uhhg
墒	uhyo
垧	uhyo
晌	uhbo
绱	uhwo
少	ukgj
烧	ukrw
稍	ukun
勺	ukhd
捎	ukfn
哨	ukon
邵	ukhp
绍	ukwo
梢	ukmn
苕	ukho
韶	ukio
蛸	ukcn
劭	ukhx
潲	ukdn
艄	uknn
芍	ukhd
筲	ukkn
召	ukho
鞘	ukhn
睄	ukbn
柖	ukmo
玿	ukio
社	uety
蛇	uecl
设	ueia
射	uerd
舍	uevo
舌	uejo
摄	uefa
涉	uedg
折	ueft
赦	ueya
奢	uerb
赊	uerg
佘	uevg
麝	uejd
慑	uela
歙	uevv
畲	uevq
阇	uenb
滠	ueda
厍	uejl
拾	uefo
猞	ueqo
𪨶	ueel
谁	uzii
神	uftf
深	ufdm
身	ufrj
申	uffi
肾	ufgn
沈	ufdw
甚	ufbl
审	ufnf
伸	ufvf
什	ufvx
砷	ufpf
慎	uflg
婶	ufaf
渗	ufdg
侁	ufvw
糁	ufgg
哂	ufos
蜃	ufjc
莘	ufhx
诜	ufiw
瘆	ufjg
甡	ufjy
参	ufug
燊	ufrm
谌	ufil
椹	ufml
矧	ufvi
绅	ufwf
呻	ufof
屾	ufee
珅	ufif
谂	ufiu
胂	ufnf
葚	ufhl
鲹	ufug
娠	ufak
棽	ufmz
瞫	ufbx
𬬹	ufzf
𬳽	ufsw
生	ugjy
声	ugyp
省	uggb
升	ugjh
胜	ugny
圣	ugay
剩	ugug
绳	ugwl
笙	ugky
昇	ugbh
盛	ugsq
晟	ugbz
牲	ugfy
甥	ugjx
陞	ugpy
眚	ugjb
乘	ugux
嵊	ugex
是	uibv
时	uibd
式	uisi
使	uivr
事	uifh
师	uigt
史	uiri
诗	uiid
市	uiie
屎	uipm
十	uixh
视	uitw
室	uiny
石	uiph
试	uiii
实	uinr
饰	uike
士	uiyh
湿	uidh
食	uikj
氏	uijs
势	uifx
世	uihh
施	uiil
失	uijr
始	uiao
尸	uipz
识	uiig
狮	uiqt
适	uijz
矢	uivr
嗜	uiob
谥	uiiq
誓	uifi
拾	uifo
弑	uixi
释	uiuf
示	uigg
恃	uild
侍	uivd
仕	uivy
逝	uifz
豕	uiqh
轼	uili
蚀	uikc
噬	uiov
匙	uibl
虱	uizc
拭	uifi
祏	uitp
铈	uize
柿	uime
奭	uirb
莳	uihd
驶	uisr
似	uivv
舐	uijs
筮	uikv
湜	uidv
栻	uimi
螫	uiyc
贳	uihr
蓍	uihb
炻	uirp
什	uivx
酾	uisd
鲥	uiud
媞	uiav
鼫	uiup
鸤	uips
嘘	uioh
鲺	uiuc
殖	uihb
峙	uied
襫	uitb
邿	uiyp
浉	uidt
埘	uiyd
䏡	uing
䴓	uits
𫚕	uiut
𬤊	uiiv
受	ubja
手	ubfj
收	ubua
首	ubkb
瘦	ubja
守	ubnd
兽	ubgo
寿	ubfd
售	ubvo
授	ubfa
熟	ubid
绶	ubwa
艏	ubnb
狩	ubqd
书	uufz
数	uuga
树	uumd
属	uupc
输	uulg
术	uumd
叔	uuya
熟	uuid
蜀	uuqc
竖	uugk
鼠	uuug
疏	uuzg
舒	uuvt
梳	uumg
赎	uurr
束	uumh
孰	uuix
述	uumz
署	uuqb
黍	uuux
塾	uuiy
姝	uuam
恕	uuau
淑	uuda
庶	uujd
戍	uusj
漱	uudv
殊	uuhm
暑	uubb
殳	uuwa
薯	uuhb
曙	uubb
抒	uuft
蔬	uuhg
枢	uumx
菽	uuha
澍	uudd
倏	uuvd
墅	uuiy
腧	uung
摅	uufu
纾	uuwt
隃	uupg
秫	uuud
沭	uudd
婌	uuaa
陎	uupm
毹	uuvl
鄃	uuvp
𬬸	uuzd
刷	uwpg
耍	uwta
唰	uwog
帅	uyge
甩	uynl
摔	uyfx
衰	uyik
率	uyix
蟀	uycx
涮	urdg
栓	urmi
拴	urfi
闩	urnh
腨	urng
双	udaa
爽	udrx
霜	udtb
泷	uddw
孀	udab
鹴	udts
骦	udsb
漴	uddg
礵	udpb
水	uvix
谁	uvii
睡	uvbi
税	uvuw
帨	uvew
说	uviw
顺	upgr
舜	upjf
瞬	upbf
吮	upow
楯	upmb
说	uoiw
硕	uopr
朔	uokn
槊	uokm
烁	uorl
搠	uofn
铄	uozl
数	uoga
妁	uoad
蒴	uohn
四	siqw
死	sihl
斯	sibt
撕	sift
丝	siwh
似	sivv
寺	siyd
思	siqu
私	siuu
司	sizo
饲	siko
嗣	sioo
巳	silz
嘶	siot
肆	siff
祀	sitl
驷	sisw
姒	siav
俟	sivr
锶	sizu
泗	sidw
厮	sijt
兕	siow
笥	siko
汜	sidl
咝	sioh
伺	sivo
鸶	siws
涘	sidr
缌	siwu
耜	simb
澌	sidt
蛳	sict
虒	sijw
飔	siwu
凘	sidt
㟃	siho
楒	simu
送	sskz
宋	ssnm
怂	ssvu
松	ssmu
颂	ssgr
诵	ssif
菘	sshu
崧	sseu
耸	ssvb
嵩	sseo
竦	ssim
淞	ssdu
讼	ssiu
娀	ssax
凇	ssdu
悚	sslm
𪨊	sspv
忪	sslu
㧐	ssfa
搜	sbfa
艘	sbna
嗖	sboa
馊	sbka
叟	sbea
廋	sbja
薮	sbha
溲	sbda
瞍	sbba
嗽	sbov
蒐	sbhw
飕	sbwa
嗾	sbor
擞	sbfa
锼	sbza
螋	sbca
苏	suhg
酥	susu
素	suyg
速	sumz
俗	suvo
诉	suit
宿	sunb
粟	susm
溯	sudn
塑	suky
肃	sufx
稣	suuu
谡	suia
愫	sulg
夙	suwd
甦	suhy
涑	sudm
窣	sunx
骕	susx
蔌	suhv
嗉	suog
簌	sukv
傃	suvg
鹔	sufs
蹜	sueb
缩	suwb
僳	suvm
觫	suhm
𫗧	sukm
算	srkh
酸	srsa
蒜	srhg
狻	srqa
岁	sved
随	svpz
虽	svoc
遂	svgz
碎	svpx
隋	svpn
穗	svuu
髓	svnz
燧	svrz
尿	svpx
隧	svpz
睢	svbi
绥	svwa
祟	sveg
荽	svha
谇	svix
眭	svby
邃	svnz
濉	svdi
旞	sviz
穟	svuz
璲	sviz
襚	svtz
𫟦	svlz
𬭼	svzz
孙	spzg
损	spfr
隼	spvx
榫	spmx
笋	spkp
飧	spdk
荪	sphg
狲	spqg
所	sojt
锁	sozr
索	soxg
缩	sowb
嗦	soog
梭	soma
娑	soda
蓑	sohk
唆	sooa
琐	soir
羧	soya
睃	soba
溹	sodg
葰	soha
唢	soor
嗍	soon
莎	sohj
挲	sodf
桫	somj
他	tavl
它	tanl
她	taal
塔	tayo
塌	taye
踏	taeb
祂	tatl
挞	tafz
拓	tafp
铊	tazl
榻	tame
牠	tafl
趿	taea
沓	taib
獭	taqr
闼	tanz
蹋	taee
鳎	taue
溻	tade
遢	tabz
鞳	taho
阘	tane
褟	tate
鿎	tapz
太	tlrd
台	tluo
态	tlru
胎	tlno
抬	tlfo
泰	tlrx
钛	tlzd
肽	tlnd
苔	tlho
汰	tldd
鲐	tluo
骀	tlso
邰	tlup
薹	tlhy
酞	tlsd
跆	tleo
炱	tlur
谈	tjir
碳	tjpr
弹	tjwt
摊	tjfi
贪	tjvr
痰	tjjr
探	tjfm
谭	tjix
叹	tjoa
滩	tjdi
坛	tjyu
坦	tjyh
炭	tjer
瘫	tjji
檀	tjmh
毯	tjlr
潭	tjdx
昙	tjbu
钽	tjzh
覃	tjsx
郯	tjrp
坍	tjyn
璮	tjih
镡	tjzx
惔	tjlr
忐	tjyu
菼	tjhr
袒	tjth
倓	tjvr
澹	tjdi
锬	tjzr
榃	tjmq
磹	tjpx
糖	thgo
汤	thdg
唐	thjo
躺	thro
烫	thdr
堂	thgy
趟	theo
棠	thgm
淌	thdo
塘	thyo
倘	thvo
膛	thny
蹚	they
帑	thae
樘	thmy
镗	thzy
傥	thvw
溏	thdo
螳	thcy
镋	thzw
搪	thfo
羰	thyr
嘡	thoy
螗	thco
瑭	thio
鄌	thjp
耥	thmo
埫	thyo
铴	thzg
䣘	thop
套	tkrf
淘	tkdu
逃	tkxz
掏	tkfu
讨	tkid
桃	tkmx
陶	tkpu
韬	tkfu
涛	tkdd
弢	tkwa
饕	tkok
绦	tkwm
洮	tkdx
叨	tkoh
滔	tkdu
萄	tkhu
焘	tkfd
梼	tkmd
绹	tkwu
啕	tkou
慆	tklu
鼗	tkxa
𫘦	tksu
特	tefd
铽	tezu
慝	tecu
忒	tesu
忑	tetu
忒	tzsu
疼	tgjg
藤	tghx
腾	tgns
滕	tgnx
熥	tgrz
誊	tggi
縢	tgng
螣	tgnc
䲢	tgnu
题	tibr
提	tifv
体	tivm
踢	tieg
替	tirb
剃	tigg
梯	timj
缇	tiwv
锑	tizj
蹄	tiee
剔	tibg
啼	tioe
悌	tilj
涕	tidj
惕	tilg
薙	tihi
醍	tisv
屉	tiph
嚏	tiov
鹈	tigs
擿	tifz
绨	tiwj
荑	tihr
倜	tivo
裼	titg
媞	tiav
鳀	tiuv
逖	tiqz
趯	tiei
瑅	tiiv
遆	tiiz
䏲	tinj
䴘	tijn
𫘨	tisv
天	tmhr
甜	tmjb
填	tmyg
田	tmqi
舔	tmjl
添	tmdl
忝	tmhl
湉	tmdo
殄	tmhg
恬	tmlo
腆	tmng
阗	tmng
掭	tmfl
觍	tmsw
瑱	tmig
沺	tmdq
畋	tmqa
淟	tmdg
晪	tmbg
盷	tmbd
黇	tmso
条	tcam
跳	tcex
挑	tcfx
调	tcio
祧	tctx
窕	tcnx
朓	tcnx
粜	tcem
蜩	tcco
佻	tcvx
眺	tcbx
苕	tcho
嬥	tcai
鲦	tcum
髫	tcfo
迢	tcho
笤	tcko
龆	tcyo
贴	txro
铁	txzr
帖	txeo
餮	txhk
萜	txho
听	tyot
挺	tyfz
停	tyvt
厅	tyjt
亭	tyit
艇	tynz
庭	tyjz
汀	tydt
廷	tyjz
婷	tyat
霆	tytz
烃	tyri
铤	tyzz
珽	tyiz
梃	tymz
渟	tydt
葶	tyht
蜓	tycz
莛	tyhz
圢	tyyt
桯	tymi
颋	tyjr
侹	tyvz
烶	tyrz
䗴	tycz
𬘩	tywz
同	tsno
通	tszz
痛	tsjf
铜	tszo
桶	tsmf
捅	tsff
筒	tsko
佟	tsvg
统	tsww
童	tsii
酮	tsso
瞳	tsbi
桐	tsmo
彤	tsng
砼	tspi
嗵	tsoz
僮	tsvi
恸	tslx
仝	tsvi
穜	tsui
潼	tsdi
烔	tsro
橦	tsmi
垌	tsyo
茼	tsho
洞	tsdo
峒	tseo
曈	tsbi
哃	tsoo
鲖	tsuo
㛚	tsaf
峂	tseg
𦒍	tsie
𫍣	tsio
头	tbgr
投	tbfa
偷	tbvg
透	tbuz
骰	tbna
图	tuqg
土	tuyh
吐	tuoy
涂	tudm
兔	tuhd
突	tund
屠	tupb
徒	tuve
凸	tuoi
秃	tuuw
途	tuvz
荼	tuhm
钍	tuzy
酴	tusm
菟	tuhd
凃	tudm
稌	tuum
堍	tuyd
腯	tunb
梌	tumm
葖	tuhd
㻬	tuis
𬳿	tusm
团	trqj
彖	troq
湍	trdg
抟	trfs
猯	trqg
疃	trqi
煓	trrg
推	tvfi
腿	tvnz
退	tvpz
忒	tvsu
颓	tvur
褪	tvtz
蜕	tvcw
煺	tvrz
魋	tvwi
𬯎	tvpr
囤	tpql
臀	tppn
吞	tpho
屯	tplh
豚	tpnq
鲀	tpul
暾	tpba
焞	tprz
饨	tpkl
坉	tpyl
褪	tptz
忳	tpll
拖	tofl
托	tofl
脱	tonw
坨	toyl
陀	topl
驼	tosl
驮	tosr
拓	tofp
妥	toja
佗	tovl
侂	tovl
唾	tooi
沱	todl
铊	tozl
橐	tofm
鼍	tool
鸵	tosl
椭	tomn
砣	topl
柁	toml
箨	tokf
跎	toel
酡	tosl
柝	tomt
圫	toyl
萚	tohf
庹	tojn
𬶍	toul
哇	waoy
挖	wafz
娃	waay
瓦	waah
蛙	wacy
袜	watm
洼	wady
娲	waan
凹	waoi
佤	wava
窊	wang
坬	wayj
腽	wanq
畖	waqj
外	wldl
歪	wlti
崴	wlea
万	wjhh
玩	wjiw
完	wjnw
晚	wjbw
碗	wjpx
弯	wjiw
丸	wjxj
湾	wjdw
挽	wjfw
绾	wjwb
腕	wjnx
纨	wjwx
烷	wjrw
剜	wjng
皖	wjjw
菀	wjhx
卍	wjxh
宛	wjnx
顽	wjgr
豌	wjhx
婉	wjax
莞	wjhw
畹	wjqx
脘	wjnw
椀	wjmx
婠	wjab
琬	wjix
惋	wjlx
蜿	wjcx
芄	wjhx
蔓	wjha
塆	wjyw
𬇕	wjdh
往	whvi
王	whih
网	whnx
望	whii
忘	whiu
汪	whdi
亡	whil
旺	whbi
妄	whia
枉	whmi
罔	whnl
辋	whll
尢	whwh
惘	whll
魍	whwl
尪	whwi
为	wzdd
位	wzvk
未	wzmh
味	wzom
微	wzva
喂	wzok
伪	wzvd
胃	wzqn
维	wzwi
威	wzsa
唯	wzoi
魏	wzuw
尾	wzpl
卫	wzph
谓	wzin
围	wzqf
韦	wzfh
惟	wzli
委	wzua
危	wzhl
薇	wzha
畏	wzqk
煨	wzrk
伟	wzvf
隈	wzpk
炜	wzrf
违	wzfz
尉	wzpd
苇	wzhf
萎	wzha
慰	wzpu
纬	wzwf
鲔	wzun
蔚	wzhd
圩	wzyt
艉	wznl
玮	wzif
帷	wzei
渭	wzdn
帏	wzef
洧	wzdn
桅	wzml
猥	wzqk
痿	wzja
巍	wzew
嵬	wzew
猬	wzqn
薳	wzhz
鳚	wzud
潍	wzdi
亹	wzib
葳	wzha
偎	wzvk
闱	wznf
诿	wzia
韪	wzbf
娓	wzal
隗	wzpw
溦	wzda
沩	wzdd
硙	wzpl
崴	wzea
煟	wzrn
廆	wzjw
逶	wzuz
碨	wzpk
涠	wzdf
洈	wzdl
霨	wztd
琟	wzii
峗	wzel
螱	wzpc
鳂	wzuk
𣲗	wzdf
𫇭	wzhd
𬀩	wzbf
𬱟	wzhr
𬶏	wzul
问	wfno
文	wfix
稳	wfuu
闻	wfnb
纹	wfwx
温	wfdq
吻	wfog
蚊	wfcx
瘟	wfjq
玟	wfix
雯	wftx
汶	wfdx
炆	wfrx
辒	wflq
刎	wfhg
阌	wfna
紊	wfig
蕰	wfhq
榅	wfmq
芠	wfhx
鳁	wfuq
璺	wfxd
𫘜	wfsx
翁	wgge
嗡	wgoe
瓮	wgga
滃	wgde
蓊	wghe
蕹	wghi
鹟	wggs
𬭩	wgze
我	wosj
喔	wooy
窝	wonn
握	wofy
沃	wodr
卧	wocl
涡	wodn
倭	wova
斡	woxx
龌	woyy
渥	wody
偓	wovy
蜗	wocn
挝	wofz
肟	wons
幄	woey
硪	wops
涴	wodx
莴	wohn
踒	woea
无	wuhw
五	wuih
物	wufg
吴	wuor
吾	wuio
勿	wuhg
乌	wusj
舞	wuvf
武	wuhy
屋	wupy
误	wuir
悟	wulo
唔	wuoo
雾	wutx
捂	wufo
伍	wuvi
戊	wusj
污	wuds
呜	wuos
午	wuvx
务	wuax
巫	wuiv
兀	wuhw
钨	wuzs
坞	wuys
恶	wuhu
毋	wuql
邬	wusw
诬	wuiv
寤	wuno
庑	wujw
侮	wuvq
焐	wuro
芜	wuhw
旿	wubx
忤	wulx
鹜	wurs
梧	wumo
晤	wubo
骛	wurs
杌	wumw
迕	wuvz
鹀	wuis
鼯	wuuo
圬	wuys
妩	wuaw
怃	wulw
洿	wuds
浯	wudo
珷	wuiy
芴	wuhg
婺	wura
鋈	wudz
屼	wuew
鹉	wuhs
铻	wuzo
珸	wuio
蜈	wucr
牾	wufo
郚	wuip
仵	wuvx
痦	wujo
靰	wuhw
峿	wueo
𣲘	wudw
系	xijg
洗	xidw
戏	xias
西	xish
细	xiwq
吸	xioa
喜	xiyo
兮	xigs
希	xixe
席	xije
膝	xinx
稀	xiue
锡	xizg
习	xiez
奚	xijr
息	xiju
昔	xisb
硒	xips
惜	xilb
袭	xiwk
溪	xidr
悉	xiuu
徙	xivv
曦	xibs
析	ximt
玺	xihd
熄	xiru
隙	xipg
夕	xidj
汐	xidd
蜥	xict
熙	xicd
茜	xihs
嘻	xioo
檄	xima
铣	xizw
晞	xibe
晰	xibt
犀	xipf
禧	xito
嬉	xiao
豨	xiqe
烯	xire
釐	ximi
隰	xipd
羲	xiys
郤	xigp
谿	xijo
郗	xixp
牺	xifs
歙	xivv
僖	xivo
熹	xiyd
咥	xioy
禊	xitr
翕	xive
觋	xiiw
皙	ximb
媳	xiau
枲	xium
嶲	xien
饩	xikk
醯	xisq
憙	xiyu
唏	xioe
舄	xiud
浠	xide
舾	xins
淅	xidt
蹊	xier
傒	xivr
螅	xicu
肸	xinx
屣	xipv
觿	xiho
酅	xiep
穸	xind
屃	xipr
蓰	xihv
潟	xidd
鳛	xiub
裼	xitg
鼷	xiur
阋	xinw
绤	xiwo
蟋	xicu
葸	xihu
樨	ximf
爔	xirs
睎	xibe
熻	xire
粞	xigs
巇	xies
窸	xinu
俙	xive
菥	xiht
恓	xils
嶍	xieb
暿	xibo
饻	xikk
𠅤	xiiu
𫘬	xisr
𬭳	xizo
𬶮	xiuo
下	xwth
瞎	xwbo
夏	xwta
侠	xwvg
虾	xwct
吓	xwot
霞	xwta
峡	xweg
瑕	xwia
狭	xwqg
匣	xwct
辖	xwlo
呷	xwot
叚	xwpa
暇	xwba
狎	xwqt
遐	xwpz
硖	xwpg
罅	xwvx
柙	xwmt
黠	xwio
厦	xwja
翈	xwte
先	xmfw
线	xmws
险	xmph
弦	xmww
现	xmiw
县	xmbu
嫌	xmas
仙	xmve
咸	xmso
显	xmbh
鲜	xmuy
限	xmpk
闲	xmnm
藓	xmhy
馅	xmku
献	xmxd
贤	xmgr
掀	xmfv
陷	xmpu
衔	xmvt
见	xmwi
酰	xmsw
氙	xmke
腺	xmnx
娴	xmam
羡	xmyv
霰	xmta
筅	xmkw
纤	xmwx
宪	xmnw
籼	xmge
蚬	xmcw
冼	xmdw
舷	xmnw
涎	xmdz
岘	xmew
苋	xmhw
狝	xmqg
跣	xmew
燹	xmqr
锨	xmzv
洗	xmdw
祆	xmtr
暹	xmbz
缐	xmwx
猃	xmqh
痫	xmjm
伭	xmvw
崄	xmeh
跹	xmez
莶	xmhh
挦	xmfd
孅	xmah
忺	xmlv
鹇	xmns
禒	xmtq
㬎	xmbd
𪾢	xmbw
𫍯	xmio
𬀪	xmbw
𬸣	xmns
想	xdmu
像	xdvq
向	xdjo
项	xdir
香	xdub
相	xdmb
象	xdhq
箱	xdkb
乡	xdwj
响	xdoo
降	xdpf
翔	xdye
橡	xdmq
巷	xdsl
享	xdiz
湘	xddb
厢	xdjb
镶	xdzk
祥	xdty
饷	xdko
飨	xdwk
详	xdiy
襄	xdik
芗	xdhj
庠	xdjy
骧	xdsk
缃	xdwb
瓖	xdik
鲞	xdgu
珦	xdio
葙	xdhb
𬙋	xdwk
小	xcgi
笑	xckr
肖	xcgn
校	xcmx
箫	xckx
孝	xcjz
逍	xcgz
萧	xchx
消	xcdn
削	xcgg
晓	xcbw
效	xcia
销	xczn
枭	xcsm
筱	xcka
鸮	xcos
骁	xcsw
咲	xcor
宵	xcnn
魈	xcwn
硝	xcpn
崤	xcen
枵	xcms
啸	xcox
绡	xcwn
霄	xctn
潇	xcdx
蛸	xccn
嚣	xcoo
虓	xcxw
翛	xcve
猇	xcqw
淆	xcdn
皛	xcjb
哮	xcoz
洨	xcdx
哓	xcow
涍	xcdz
滧	xcda
蟏	xccx
敩	xcga
𫍲	xcia
写	xxnh
些	xxyg
鞋	xxhy
血	xxjq
谢	xxid
斜	xxvx
蟹	xxhc
邪	xxrw
携	xxfh
卸	xxvp
歇	xxbv
屑	xxpn
挟	xxfg
协	xxxg
泻	xxdh
泄	xxdh
蝎	xxcl
械	xxmh
偕	xxvb
燮	xxra
谐	xxib
胁	xxng
解	xxhf
榭	xxmd
楔	xxmr
薤	xxhh
澥	xxdf
亵	xxik
缬	xxwr
懈	xxlf
绁	xxwh
撷	xxfr
絜	xxfg
廨	xxjf
獬	xxqf
渫	xxdm
勰	xxxu
偰	xxvr
瀣	xxdh
颉	xxyr
邂	xxhz
揳	xxfr
叶	xxox
薢	xxhf
躞	xxea
榍	xxmn
㙦	xxvy
𤫉	xxia
𬹼	xxyg
新	xnit
心	xnul
信	xnvi
芯	xnhu
锌	xnzx
辛	xnix
薪	xnht
欣	xnjv
鑫	xnzz
馨	xnyb
昕	xnbt
忻	xnlt
歆	xniv
衅	xnjf
炘	xnrt
镡	xnzx
囟	xnjx
伈	xnvu
莘	xnhx
䜣	xnit
𫷷	xnjv
型	xysy
性	xyly
星	xyby
行	xyvt
形	xysg
姓	xyay
醒	xysy
兴	xygg
邢	xysw
刑	xysg
幸	xyyy
杏	xymo
腥	xyny
陉	xypi
擤	xyfk
荇	xyht
省	xygb
饧	xykg
猩	xyqy
煋	xyry
骍	xysx
婞	xyay
惺	xyly
荥	xyhx
铏	xyzg
悻	xyly
钘	xyzs
瑆	xyiy
硎	xypg
𫰛	xyai
胸	xsnu
熊	xsud
凶	xsxu
兄	xsow
雄	xsxi
匈	xshu
芎	xshw
夐	xsha
讻	xsiu
汹	xsdu
诇	xsio
修	xqvg
秀	xquw
休	xqvm
绣	xqwh
嗅	xqod
溴	xqdd
锈	xqzh
羞	xqyh
袖	xqty
咻	xqom
脩	xqvn
岫	xqey
朽	xqms
髹	xqfm
宿	xqnb
琇	xqih
貅	xqqm
庥	xqjm
滫	xqdn
臭	xqjd
珛	xqin
馐	xqkh
鸺	xqvs
䗛	xqcn
需	xutg
虚	xujh
徐	xuvm
须	xugr
许	xuix
续	xuwr
序	xujt
嘘	xuoh
叙	xuva
恤	xulq
蓄	xuhq
旭	xuxb
戌	xush
绪	xuwb
絮	xuag
墟	xuyh
胥	xutn
圩	xuyt
栩	xume
诩	xuie
吁	xuot
婿	xuan
昫	xubo
煦	xubd
媭	xuga
勖	xunx
蓿	xuhb
盱	xubt
酗	xusu
顼	xuir
糈	xugn
溆	xuda
欻	xurv
洫	xudq
湑	xudn
畜	xuiq
醑	xusn
浒	xudx
旴	xubt
垿	xuyt
魆	xuwl
谞	xuin
珝	xuie
㳚	xuds
冔	xunt
𦈡	xuwg
𬣙	xuit
选	xrfz
癣	xrjy
悬	xrbu
炫	xrrw
玄	xriw
宣	xrnh
旋	xriv
轩	xrlt
萱	xrhh
璇	xriv
泫	xrdw
渲	xrdh
喧	xroh
玹	xriw
烜	xrrh
铉	xrzw
漩	xrdv
暄	xrbh
瑄	xrih
谖	xria
绚	xrwb
楦	xrmh
券	xrgh
煊	xrrh
衒	xrvt
眩	xrbw
咺	xroh
儇	xrvk
禤	xrte
晅	xrbh
翾	xrqe
碹	xrph
昡	xrbw
琄	xrin
痃	xrjw
暶	xrbv
愃	xrlh
𫍽	xrik
𫓶	xrzn
𫠊	xrsw
学	xtgz
血	xtjq
雪	xtte
薛	xthx
靴	xthl
穴	xtng
削	xtgg
谑	xtie
噱	xtoq
鳕	xtue
踅	xtfe
茓	xthg
峃	xtge
寻	xped
熏	xpid
训	xpig
逊	xpzz
巡	xpgz
勋	xpox
埙	xpyr
巽	xplg
讯	xpix
循	xpvb
荀	xphb
旬	xphb
殉	xphb
薰	xphd
询	xpib
迅	xpzz
洵	xpdb
徇	xpvb
驯	xpsg
蕈	xphx
浔	xpdd
郇	xphp
鲟	xpud
荨	xphd
恂	xplb
醺	xpsd
栒	xpmb
曛	xpbd
獯	xpqd
汛	xpdx
珣	xpib
噀	xpog
峋	xpeb
浚	xpda
𫄸	xpwd
𬊈	xprd
𬍤	xpid
𬘓	xpwg
𬩽	xpep
呀	yaor
压	yajd
牙	yarh
鸭	yats
亚	yahh
雅	yari
押	yaft
丫	yayd
芽	yahr
吖	yaoy
娅	yaah
哑	yaoh
崖	yaey
涯	yady
氩	yakh
鸦	yars
伢	yavr
衙	yavt
轧	yall
蚜	yacr
垭	yayh
猰	yaqr
玡	yair
琊	yaip
砑	yapr
桠	yamh
迓	yarz
讶	yair
揠	yafa
睚	yaby
岈	yaer
堐	yayy
盐	yjyq
眼	yjbk
演	yjdg
烟	yjrr
言	yjid
沿	yjdo
研	yjps
焉	yjid
严	yjhj
颜	yjir
腌	yjnl
岩	yjep
宴	yjna
燕	yjhd
验	yjsh
炎	yjrr
咽	yjor
延	yjjz
彦	yjig
阎	yjnu
厌	yjjd
艳	yjfl
掩	yjfl
闫	yjng
焰	yjru
淹	yjdl
晏	yjba
俨	yjvj
雁	yjji
鄢	yjip
妍	yjas
嫣	yjad
阏	yjng
檐	yjmi
偃	yjva
焱	yjrr
衍	yjvt
阉	yjnl
砚	yjpw
魇	yjjw
甗	yjja
兖	yjiw
谳	yjid
筵	yjkz
罨	yjql
赝	yjjr
弇	yjvh
湮	yjdy
酽	yjsj
奄	yjrl
琰	yjir
堰	yjya
餍	yjjk
郾	yjcp
滟	yjdl
沇	yjdw
芫	yjhw
铅	yjzo
谚	yjig
黡	yjjd
嬿	yjad
唁	yjoi
胭	yjnr
蜒	yjcz
渰	yjdh
墕	yjyd
棪	yjmr
戭	yjns
掞	yjfr
蝘	yjca
殷	yjja
鼹	yjua
崦	yjel
厣	yjjt
恹	yjld
漹	yjdd
虤	yjjw
扊	yjdr
䶮	yjwr
觃	yjwz
𪩘	yjed
𫄧	yjwz
𬙂	yjwg
𬸘	yjcs
杨	yhmg
养	yhyg
羊	yhyd
样	yhmy
氧	yhky
阳	yhpb
痒	yhjy
洋	yhdy
扬	yhfg
央	yhri
仰	yhvp
漾	yhdx
鞅	yhhr
旸	yhbg
秧	yhur
佯	yhvy
烊	yhry
殃	yhhr
飏	yhwg
炀	yhrg
钖	yhzg
羕	yhyx
疡	yhjg
鸯	yhrs
恙	yhyu
垟	yhyy
蛘	yhcy
泱	yhdr
怏	yhlr
玚	yhig
徉	yhvy
咉	yhor
要	yksa
药	ykhd
腰	ykna
妖	ykar
咬	ykox
邀	ykjz
摇	ykfu
尧	yksw
姚	ykax
舀	ykju
约	ykwd
幺	ykwl
曜	ykbi
瑶	ykiu
谣	ykiu
窑	yknu
遥	ykjz
垚	ykyy
爻	ykxx
夭	ykjr
耀	ykgi
吆	ykow
杳	ykmb
窈	yknx
峣	ykew
肴	ykxn
徭	ykvu
钥	ykzn
鳐	ykuu
窅	yknb
鹞	ykjs
铫	ykzx
珧	ykix
轺	yklo
疟	ykje
靿	ykhx
侥	ykvw
崾	ykea
猺	ykqu
媱	ykau
㙘	ykya
也	yelz
页	yetr
叶	yeox
野	yeit
夜	yeia
业	yexh
耶	yebw
液	yeda
爷	yegp
噎	yeok
邺	yexp
掖	yefa
谒	yeil
椰	yemp
曳	yesi
冶	yedo
晔	yebx
烨	yerx
铘	yezp
腋	yena
靥	yejq
倻	yevp
咽	yeor
馌	yekq
揶	yefp
以	yilv
一	yihh
亿	yivz
已	yilz
亦	yiix
易	yibg
矣	yiur
乙	yizz
译	yiif
意	yiiu
仪	yivx
依	yivk
咦	yior
伊	yivp
椅	yimo
衣	yiik
医	yicr
义	yidx
翼	yieg
宜	yinb
异	yilh
裔	yiio
益	yikq
邑	yiol
移	yiud
壹	yiyk
役	yiva
奕	yiir
夷	yirh
艺	yihz
疑	yilv
倚	yivo
逸	yihz
姨	yiar
忆	yilz
遗	yiyz
议	yiix
蚁	yicx
噫	yiou
抑	yifp
怡	yilo
乂	yixj
铱	yizk
溢	yidq
驿	yisf
疫	yija
翊	yiie
埸	yiyg
胰	yinr
刈	yixg
颐	yicr
毅	yiia
钇	yizz
懿	yiyu
诣	yiib
彝	yioh
揖	yifb
弋	yish
翳	yice
轶	yilr
羿	yieh
祎	yitf
猗	yiqo
尾	yipl
镒	yizq
贻	yiro
佚	yivr
燚	yirr
谊	yiib
弈	yiih
诒	yiio
咿	yiop
扆	yidk
镱	yizu
佾	yivn
浥	yidl
臆	yinu
瘗	yijy
缢	yiwq
沂	yidt
殪	yihk
峄	yief
圯	yiyl
绎	yiwf
熠	yirb
迤	yivl
劓	yijg
翌	yiek
漪	yido
苡	yihv
饴	yiko
嶷	yiev
匜	yicl
屹	yiez
肄	yilf
挹	yifl
裛	yiik
潩	yidg
舣	yinx
怿	yilf
踦	yieo
螠	yicq
嗌	yioq
簃	yikd
薏	yihu
黟	yiid
洢	yidp
繄	yicg
荑	yihr
旖	yiio
佁	yivo
悒	yill
嫕	yiau
鹢	yiks
勚	yihx
呓	yioz
眙	yibo
蜴	yicg
酏	yisl
鹝	yihs
艾	yihx
廙	yijg
枍	yims
癔	yiju
痍	yijr
杙	yims
宧	yinc
椸	yiml
扅	yidd
㑊	yivx
𫄷	yiwu
𫖮	yier
𬟁	yihs
𬬩	yizs
𬺈	yiyo
因	ynqr
音	ynib
银	ynzk
印	ynep
引	ynwi
阴	ynpn
饮	ynkv
隐	ynpu
瘾	ynju
殷	ynja
尹	ynpz
吟	ynoz
寅	ynng
荫	ynhn
淫	yndy
胤	ynjl
龈	ynyk
铟	ynzr
洇	yndr
蚓	ynci
茵	ynhr
鄞	ynhp
堙	ynyy
愔	ynlb
骃	ynsr
喑	ynob
垠	ynyk
窨	ynnb
氤	ynkr
禋	ynty
嚚	ynoo
霪	ynty
姻	ynar
訚	ynni
龂	ynyt
崟	ynez
慭	ynmu
夤	yndg
溵	ynda
茚	ynhp
狺	ynqi
蟫	yncx
吲	ynoi
硍	ynpk
珢	ynik
歅	ynsv
䲟	ynup
𬘡	ynwr
𬤇	yniy
𬮱	ynny
应	yyjh
硬	yypr
赢	yyid
英	yyhr
营	yyho
樱	yyma
影	yybg
鹰	yyjs
迎	yycz
盈	yyhq
嬴	yyid
郢	yyop
嘤	yyoa
瑛	yyir
蝇	yycl
颖	yylr
映	yybr
莺	yyhs
萤	yyhc
婴	yyra
瀛	yydd
莹	yyhd
颍	yylr
媵	yyna
鹦	yyrs
膺	yyjn
瘿	yyja
缨	yywa
楹	yymq
荧	yyhr
萦	yyhg
罂	yyru
撄	yyfa
锳	yyzr
滢	yydd
荥	yyhx
溁	yydm
潆	yydg
蓥	yyhz
璎	yyia
茔	yyhy
媖	yyar
䓨	yyhu
哟	yood
唷	yoon
育	yoin
用	ysnf
勇	yszx
永	ysix
咏	ysox
拥	ysff
涌	ysdf
庸	ysjf
蛹	yscf
雍	ysii
颙	yscr
俑	ysvf
佣	ysvf
慵	yslf
泳	ysdx
踊	ysef
壅	ysiy
痈	ysjf
甬	yszf
鳙	ysuf
饔	ysik
邕	ysgl
镛	yszf
鄘	ysjp
澭	ysdi
臃	ysni
墉	ysyf
喁	ysoc
恿	yszu
埇	ysyf
栐	ysmx
㶲	ysrf
鲬	ysuf
有	ybxn
又	ybaz
由	ybyi
油	ybdy
右	ybxo
游	ybdz
哟	ybod
呦	ybox
优	ybvd
友	ybxa
尤	ybwd
铀	ybzy
鼬	ybuy
犹	ybqd
佑	ybvo
祐	ybto
忧	ybld
幽	ybew
釉	ybuy
幼	ybwx
邮	ybyw
酉	ybsh
疣	ybjd
诱	ybih
悠	ybvu
柚	ybmy
宥	ybnn
鱿	ybud
攸	ybva
繇	ybjg
囿	ybqn
卣	yblq
侑	ybvn
铕	ybzn
猷	ybgd
牖	ybkd
莠	ybhh
蚴	ybcx
麀	ybjl
羑	ybyn
鲉	ybuy
莜	ybha
黝	ybix
莸	ybhd
耰	ybma
槱	ybmd
蝤	ybcs
浟	ybda
蝣	ybcz
蚰	ybcy
𬨎	ybfs
与	yush
于	yuth
鱼	yuuj
宇	yunt
於	yuig
欲	yugv
语	yuio
雨	yutx
余	yuvm
预	yuzr
玉	yuid
羽	yuee
域	yuyh
瑜	yuig
遇	yucz
御	yuvp
禹	yucj
逾	yuvz
愈	yuvu
俞	yuvg
虞	yujr
渔	yudu
予	yuzt
豫	yuzq
愚	yucu
驭	yusa
喻	yuog
渝	yudg
裕	yuto
育	yuin
郁	yuxp
狱	yuqd
瘀	yujg
浴	yudo
舆	yuxg
彧	yush
娱	yuar
鹬	yurs
芋	yuht
峪	yueo
誉	yugi
隅	yupc
昱	yubk
欤	yusv
谕	yuig
榆	yumg
寓	yunc
淤	yudg
鬻	yuwy
煜	yurk
毓	yuvg
阈	yunh
圉	yuqy
聿	yufz
吁	yuot
瑀	yuic
鄅	yucw
庾	yujr
愉	yulg
盂	yutq
钰	yuzd
迂	yutz
屿	yueh
禺	yuci
竽	yukt
遹	yurz
淯	yudn
妤	yuat
窳	yunj
纡	yuwt
妪	yuax
鹆	yugs
俣	yuvr
喁	yuoc
棫	yumh
燠	yurr
雩	yuts
腴	yunr
舁	yuuh
玙	yuih
谀	yuir
矞	yuro
敔	yuia
饫	yukr
畬	yuvq
熨	yupr
潏	yudo
堉	yuyn
嵛	yueg
蜮	yuch
圄	yuqo
艅	yunm
揄	yufg
萸	yuhr
邘	yutw
臾	yurj
褕	yutg
燏	yuro
窬	yung
髃	yunc
瘐	yujr
觎	yuvw
龉	yuyo
嵎	yuec
尉	yupd
蔚	yuhd
狳	yuqm
滪	yudr
伛	yuvx
蝓	yucg
蓣	yuhr
悆	yuvu
㺄	yuqg
元	yrgw
原	yrjg
远	yrgz
源	yrdg
愿	yrju
圆	yrqr
院	yrpw
员	yror
园	yrqw
袁	yryk
猿	yrqk
缘	yrwq
怨	yrxu
冤	yrnd
苑	yrhx
渊	yrdi
援	yrfa
爰	yrja
垣	yryh
鸢	yrss
螈	yrcg
鼋	yrgl
沅	yrdw
妧	yraw
媛	yraa
掾	yrfq
塬	yryg
瑗	yria
鸳	yrxs
嫄	yrag
辕	yrlk
芫	yrhw
涴	yrdx
垸	yryw
橼	yrmq
蜎	yrcn
眢	yrxb
圜	yrqk
湲	yrda
箢	yrkx
羱	yryg
𫘪	yrsg
月	ytnj
越	ytel
约	ytwd
曰	ytbi
粤	ytjs
岳	ytoe
乐	ytlj
悦	ytlw
阅	ytnw
跃	yter
钺	ytzl
玥	ytin
樾	ytml
刖	ytng
籥	ytkh
龠	ytvh
瀹	ytdh
哕	ytod
栎	ytml
爚	ytrh
钥	ytzn
彟	ytea
𫐄	ytlw
𬸚	ytqs
云	ypgu
运	ypgz
晕	ypbl
韵	ypid
孕	yphz
匀	yphd
允	ypuw
熨	yppr
芸	yphu
陨	yppr
愠	yplq
筠	ypkd
蕴	yphq
殒	yphr
昀	ypbd
妘	ypau
赟	ypir
狁	ypqw
韫	ypfq
恽	ypll
氲	ypkq
缊	ypwq
郓	ypnp
耘	ypmu
郧	ypop
酝	ypsu
筼	ypkr
煴	yprq
沄	ypdu
纭	ypwu
鋆	ypyz
涢	ypdr
员	ypor
馧	ypuq
𫖳	yppr
咋	zaok
砸	zape
杂	zaxm
咂	zaoe
匝	zace
扎	zafl
拶	zafd
臜	zanr
在	zlxy
再	zlhn
载	zlxl
哉	zlxo
崽	zleu
宰	zlnx
仔	zlvz
栽	zlxm
灾	zlnr
甾	zlgq
赞	zjfr
咱	zjob
攒	zjfr
暂	zjlb
簪	zjkb
錾	zjlz
瓒	zjir
拶	zjfd
昝	zjab
酂	zjfp
趱	zjer
糌	zjgb
寁	zjnv
脏	zhny
葬	zhhh
臧	zhsc
藏	zhhc
牂	zhky
赃	zhry
奘	zhkr
驵	zhsb
早	zkbx
造	zkfz
遭	zksz
灶	zkry
糟	zkgb
枣	zkmg
凿	zkxu
澡	zkdm
皂	zkjl
燥	zkrm
躁	zkem
藻	zkhm
噪	zkom
蚤	zkac
璪	zkim
慥	zklz
簉	zkkz
唣	zkol
𥖨	zkpm
则	zerg
啧	zeor
泽	zedf
择	zeff
责	zeyr
仄	zejv
帻	zeer
昃	zebv
咋	zeok
迮	zevz
笮	zekk
箦	zekr
赜	zecr
舴	zenk
贼	zzrx
鲗	zzug
怎	zfvu
谮	zfib
增	zgyb
赠	zgrb
甑	zgga
缯	zgwb
曾	zggb
憎	zglb
鄫	zggp
罾	zgqb
矰	zgvb
锃	zgzi
综	zgwg
䎖	zgge
炸	vark
渣	vadh
扎	vafl
榨	vamk
乍	vavk
札	vaml
闸	vant
诈	vaik
眨	vabz
吒	vaol
栅	vamh
咤	vaol
铡	vazg
轧	vall
揸	vafh
鲊	vauk
砟	vapk
楂	vamh
劄	vakg
喳	vaoh
霅	vati
拃	vafk
咋	vaok
溠	vadi
哳	vaot
奓	vard
蚱	vack
查	vamh
馇	vakh
挓	vafl
柞	vamk
喋	vaom
痄	vajk
䃎	vapd
鲝	vayu
齇	vajb
债	vlvr
窄	vlnk
宅	vlnl
摘	vlfo
寨	vlnm
斋	vlig
翟	vlei
祭	vlxg
择	vlff
瘵	vljg
豸	vlqj
站	vjio
占	vjlo
战	vjls
斩	vjlt
粘	vjgo
沾	vjdo
展	vjpk
詹	vjhi
蘸	vjhd
栈	vjms
盏	vjsq
毡	vjlo
瞻	vjbi
旃	vjin
绽	vjwv
湛	vjdl
辗	vjlk
鳣	vjuh
鹯	vjis
飐	vjwo
崭	vjet
栴	vjmn
谵	vjii
偡	vjvl
搌	vjfk
𫗴	vjkh
张	vhwk
章	vhix
涨	vhdk
长	vhkj
帐	vhek
账	vhrk
仗	vhvr
掌	vhgf
杖	vhmr
胀	vhnk
丈	vhrh
彰	vhig
障	vhpx
璋	vhix
蟑	vhcx
鄣	vhip
瘴	vhjx
漳	vhdx
嶂	vhex
獐	vhqx
樟	vhmx
幛	vhex
仉	vhvw
嫜	vhax
暲	vhbx
找	vkfs
招	vkfo
赵	vkex
照	vkbd
兆	vkxj
罩	vkqx
诏	vkio
昭	vkbo
召	vkho
朝	vkxn
着	vkyb
棹	vkmx
肇	vkdf
钊	vkzg
沼	vkdo
曌	vkbi
爪	vkjj
旐	vkix
笊	vkkj
啁	vkoo
𬬿	vkzo
𬶐	vkux
这	veiz
者	vejb
着	veyb
折	veft
浙	vedt
遮	vejz
哲	vefo
辄	vell
锗	vezb
褶	vetb
蛰	vefc
辙	vela
啫	veob
柘	vemp
谪	veio
蜇	vefc
喆	veyo
磔	vepm
赭	veyb
蔗	vehd
晢	vefb
詟	vewi
鹧	vejs
䗪	vejc
真	vfxg
朕	vfnr
镇	vfzg
帧	vfer
针	vfzx
阵	vfpl
枕	vfmw
震	vftk
臻	vfhu
珍	vfig
甄	vfsa
振	vffk
贞	vflr
箴	vfko
诊	vfig
缜	vfwg
斟	vfbx
侦	vfvr
鸩	vfws
砧	vfpo
赈	vfrk
祯	vftr
轸	vflg
榛	vfmu
疹	vfjg
桢	vfmr
胗	vfng
圳	vfyg
畛	vfqg
稹	vfug
禛	vftg
鬒	vffg
瑧	vfiu
葴	vfho
蓁	vfhu
揕	vffl
袗	vftg
浈	vfdr
昣	vfbg
纼	vfwi
正	vgih
证	vgii
挣	vgft
蒸	vghd
整	vgmi
症	vgji
争	vght
郑	vgkp
征	vgvi
政	vgia
睁	vgbt
筝	vgkt
怔	vgli
烝	vgwd
钲	vgzi
铮	vgzt
狰	vgqt
拯	vgfh
峥	vget
诤	vgit
只	viog
之	vidz
至	vihy
值	vivb
指	vifb
纸	viws
制	vijg
治	vido
直	vixb
知	vivo
支	vixa
致	viha
质	vijr
汁	vidx
志	viyu
置	viqb
智	vivb
止	viyi
酯	visb
职	vibg
执	vifx
掷	vifp
枝	vima
痣	viju
脂	vinb
趾	viey
彘	viol
织	viwg
吱	vioa
芝	vihz
植	vimb
滞	vide
跖	viep
炙	vidr
秩	viur
旨	vilb
侄	vivy
徵	viva
祗	vitd
栀	viml
芷	vihy
址	viyy
雉	vivi
窒	viny
肢	vina
陟	vipg
痔	vijd
沚	vidy
枳	vimg
栉	vimp
稚	viui
卮	vijl
挚	viff
郅	vihp
轵	vilg
殖	vihb
畤	viqd
峙	vied
絷	vifg
帙	vier
摭	vifd
蛭	vicy
鸷	vifs
铚	vizy
蜘	vico
踬	vier
祉	vity
埴	viyb
帜	vieg
豸	viqj
扺	vifs
贽	vifr
锧	vizr
骘	vips
踯	viep
咫	vipg
觯	viht
桎	vimy
滍	vidc
泜	vidd
黹	vixg
轾	vily
跱	vied
忮	vila
氏	vijs
稙	viub
疐	vixv
识	viig
禔	vitv
胝	vind
晊	viby
庤	vijd
梽	vimu
榰	vimb
𦭜	vihg
𬃊	vimr
中	vsfi
种	vsuf
重	vsij
众	vsvv
钟	vszf
终	vswg
忠	vsfu
肿	vsnf
冢	vsnq
仲	vsvf
盅	vsfq
锺	vszi
柊	vsmg
踵	vsei
衷	vsik
舯	vsnf
螽	vsac
茽	vshf
周	vbno
轴	vbly
州	vbgg
粥	vbww
咒	vbow
肘	vbnd
洲	vbdg
舟	vbnj
皱	vbha
昼	vbph
纣	vbwd
胄	vbyn
骤	vbsq
宙	vbny
籀	vbkq
酎	vbsd
诌	vbie
绉	vbwe
帚	vbee
辀	vbln
啁	vboo
鸼	vbns
赒	vbro
碡	vbpq
婤	vbao
妯	vbay
荮	vbhd
㑇	vbve
㤘	vble
主	vuid
住	vuvi
注	vudi
煮	vujd
猪	vuqb
祝	vutw
著	vuhb
朱	vujm
柱	vumi
诸	vuib
助	vubx
驻	vusi
竹	vuvi
诛	vuim
渚	vudb
珠	vuim
株	vumm
铸	vuzd
逐	vuqz
筑	vukd
蛛	vucm
箸	vukb
邾	vujp
铢	vuzm
烛	vurc
蛀	vuci
贮	vurh
嘱	vuoc
拄	vufi
炷	vuri
洙	vudm
茱	vuhm
伫	vuvh
竺	vukg
纻	vuwh
瞩	vubc
苎	vuhh
麈	vuji
槠	vumb
舳	vuny
疰	vuji
杼	vumt
潴	vudb
侏	vuvm
翥	vuje
砫	vupi
柷	vumw
躅	vuec
蠋	vucc
橥	vuqm
术	vumd
瘃	vujq
𬣞	vuih
抓	vwfj
爪	vwjj
髽	vwfy
拽	vyfs
转	vrls
赚	vrrs
专	vrsh
砖	vrps
撰	vrfg
传	vrvs
篆	vrkq
馔	vrkg
颛	vrer
僎	vrvg
啭	vros
瑑	vriq
沌	vrdl
䏝	vrns
装	vdkk
状	vdkd
撞	vdfi
庄	vdjy
妆	vdka
桩	vdmy
壮	vdky
幢	vdei
戆	vdiu
奘	vdkr
追	vvjz
坠	vvpy
锥	vvzi
缀	vvwa
椎	vvmi
隹	vvvi
骓	vvsi
赘	vvyr
缒	vvwz
惴	vvlg
准	vpdi
肫	vpnl
屯	vplh
谆	vpiz
窀	vpnl
衠	vpvt
𬘯	vpwz
桌	volm
捉	vofe
啄	vooq
卓	volx
浊	vodc
灼	vord
着	voyb
拙	vofu
斫	vopt
酌	vosd
叕	voaa
擢	vofi
濯	vodi
焯	vorx
镯	vozc
琢	voiq
涿	vodq
汋	vodd
倬	vovx
茁	vohu
浞	vode
椓	vomq
禚	votd
诼	voiq
棁	vomw
晫	vobx
䓬	vohx
䦃	vozb
𬸦	vois
字	zinz
自	zijb
子	zizz
紫	ziyg
兹	zikw
资	zidr
仔	zivz
籽	zigz
姿	zida
滋	zidw
渍	zidr
梓	zimx
嗞	ziow
姊	ziaj
咨	zido
恣	zidu
赀	ziyr
訾	ziyi
髭	zifl
笫	zikj
粢	zidm
吱	zioa
缁	ziwq
孖	zizz
眦	zibl
孳	zikz
觜	ziyf
龇	ziyl
孜	ziza
滓	zidx
辎	zilq
淄	zidq
秭	ziuj
茈	zihl
镃	zizw
耔	zimz
嵫	ziew
鼒	zixx
虸	zicz
锱	zizq
趑	ziev
鲻	ziuq
鄑	zihp
总	zsgu
宗	zsng
纵	zswv
棕	zsmg
综	zswg
粽	zsgg
踪	zseg
鬃	zsfg
腙	zsng
疭	zsjv
倧	zsvg
枞	zsmv
鬷	zsha
偬	zsvu
走	zbeh
揍	zbfr
奏	zbrr
邹	zbhp
陬	zbpa
诹	zbia
驺	zbse
鲰	zbua
鄹	zbbp
组	zuwb
族	zuir
足	zuei
租	zuub
卒	zuix
祖	zutb
阻	zupb
俎	zuvb
菹	zuhb
镞	zuzr
诅	zuib
崒	zuex
珇	zuib
钻	zrzo
攥	zrfg
纂	zrkg
缵	zrwr
躜	zrer
最	zvba
嘴	zvof
罪	zvqx
醉	zvsx
蕞	zvha
槜	zvmh
咀	zvob
尊	zpgd
遵	zpgz
樽	zpmd
鳟	zpud
噂	zpod
撙	zpfd
僔	zpvd
嶟	zped
𨱔	zpzd
做	zova
作	zovk
坐	zovy
左	zoxi
座	zojy
佐	zovi
嘬	zooa
昨	zobk
撮	zofa
唑	zooy
酢	zosk
祚	zotk
琢	zoiq
怍	zolk
阼	zopk
胙	zonk
捽	zofx
柞	zomk
笮	zokk
岞	zoek
