啊	aakk
阿	aaek
吖	aaky
锕	aajk
腌	aaod
爱	aipy
哎	aikx
唉	aikd
艾	aicx
挨	aifd
癌	aibs
矮	aiun
哀	aiwh
埃	aitd
碍	aiuc
欸	aivr
砹	aiux
隘	aiem
瑷	aiwy
暧	aioy
毐	aiuw
嗳	aiky
蔼	aicv
锿	aijh
霭	aiyv
嗌	aikm
叆	aiey	5
嫒	ainy	4
皑	aibj
按	anfn
安	angn	4
案	angl
俺	anrd	5
暗	anoo
氨	anqn	5
胺	anon	4
庵	angd
岸	ansg
鞍	ancn
黯	anho
铵	anjn
桉	anln
唵	ankd
谙	anyo
埯	antd
盦	anrm	4
垵	antn
犴	anqg
鹌	andn
昂	ahoe
卬	ahpe
盎	ahym
肮	ahoj
奥	aopd	5
熬	aoae	5
嗷	aokw
澳	aodd
凹	aoaa
傲	aorw
敖	aoaw
鳌	aoay
袄	aopy	4
螯	aoai	4
拗	aofl
坳	aotl
獒	aoaq
媪	aonm
岙	aoys
翱	aobx
遨	aozw
鏊	aoaj
薁	aocd
懊	aoxd
璈	aoww
鏖	aogj
骜	aoam
隩	aoed	3
聱	aoae
奡	aoaa
廒	aogw
嶅	aoas
吧	bakb
把	bafb
八	bapn
巴	bavv
扒	bafb
拔	bafy
罢	basv
叭	bakb
爸	babb
靶	bacb
钯	bajb
疤	babb	4
霸	bayo
芭	bacb
耙	bafb	5
坝	batr
灞	bado
捌	bafd
跋	bazy
粑	bamb
魃	bagy
鲃	baeb
妭	bany
鲅	baey
菝	bacy
羓	baeb
胈	baoy
朳	balb
笆	bavb
岜	basb
蚆	baib
白	blpo
摆	blfv
拜	blpf
百	blab
掰	blpu
败	blbw
柏	bllb
佰	blro	4
稗	blhu
捭	blfu
伯	blrb	5
版	bjpy	5
班	bjww	4
半	bjda
板	bjly
般	bjvy
办	bjld
搬	bjfy	5
拌	bjfb
斑	bjww	5
伴	bjrb
瓣	bjlu	3
扮	bjfd
扳	bjfy	4
绊	bjsb
颁	bjbr
坂	bjty
阪	bjey
钣	bjjy
癍	bjbw
柈	bjlb
攽	bjbw
瘢	bjby	4
昄	bjoy
湴	bjdy
靽	bjcb
帮	bhbj
棒	bhlf
榜	bhlf
磅	bhuf
邦	bhae
绑	bhse
镑	bhjf
傍	bhrf
蚌	bhif
浜	bhdb
谤	bhyf
梆	bhle
膀	bhof
搒	bhff
玤	bhwf
蒡	bhcf
塝	bhtf
包	bkpv
宝	bkgy
报	bkfy
保	bkrl
爆	bkhu
抱	bkfv
薄	bkcc
堡	bkrt
曝	bkou	5
饱	bkuv
鲍	bkev
煲	bkrh
剥	bkld
暴	bkou	4
豹	bkpu
刨	bkbd
褒	bkwh	5
胞	bkov
葆	bkcl
苞	bkcv	5
鸨	bkbn
炮	bkhv
雹	bkyv
孢	bkzv
枹	bklv
龅	bkvv	4
趵	bkzu
褓	bkpl	4
瀑	bkdu
被	bzpy	4
背	bzbo	4
倍	bzrk
呗	bzkr
杯	bzlb
北	bzab	5
贝	bzar
备	bzwt
悲	bzfx
碑	bzuu
辈	bzfi
钡	bzjr
焙	bzhk
邶	bzbe
卑	bzpu
悖	bzxz	4
孛	bzuz
蓓	bzck
陂	bzey	5
碚	bzuk
琲	bzwf
惫	bzwx	5
鹎	bzbn
鞴	bzcy
狈	bzqr
棓	bzlk
椑	bzlu
褙	bzpo
糒	bzmy
臂	bzuo
鐾	bzuj
鞁	bzcy	3
本	bfaa
笨	bfvb
奔	bfdh
苯	bfcb
畚	bfvt
贲	bfur
锛	bfjh
犇	bfnn
坌	bfbt
夯	bfdl
倴	bfrh
栟	bflk
崩	bgso
蹦	bgzo
泵	bguu
甭	bgby
绷	bgso
嘣	bgko
迸	bgzk
甏	bguw
蚌	bgif
琫	bgwf
祊	bgpf
镚	bgjo
比	bibb	5
笔	bivm	4
逼	bizt	5
必	bidd	5
币	bipj
鼻	biza
臂	biuo
壁	biut
彼	biry
毕	bibu
避	bizu
碧	biwk
哔	biku
闭	bimc
弊	biba
璧	biuy
铋	bijb
敝	bidw
匕	bipv
毙	bibb	4
俾	biru
鄙	bike	5
蔽	bicw	5
婢	binu
濞	bidb
庇	bigb	4
畀	bita
陛	biet
弼	bigg
痹	biba
妣	binb
髀	bigu
吡	bikb
箅	biva
滗	bidm	5
庳	bigu
嬖	biun
芘	bicb	4
沘	bidb	4
毖	bibb
蓖	bicb	5
裨	bipu
苾	bicb
愎	bixw
篦	bivb	5
邲	bibe	4
皕	bibo	4
襞	biuh
萆	bicu	4
荜	bicu	5
薜	bicu	3
跸	bizu
咇	bikb	4
珌	biwb	5
舭	bivb
辟	biuu
佖	birb
赑	bibr
荸	bicz	4
诐	biyy
筚	bivu
秕	bihb	5
贲	biur
狴	biqt
觱	biky	4
馝	bihb	4
泌	bidb
秘	bihb	5
鲾	biet
坒	bibt
便	bmrg
边	bmzl
变	bmwy
遍	bmzc
编	bmsc
贬	bmbf
辩	bmlu	5
扁	bmhc	5
鞭	bmcg
辨	bmlu	4
蝙	bmic	4
卞	bmwb
煸	bmhc	5
弁	bmva
辫	bmlu	3
匾	bmkc
汴	bmdb
抃	bmfb
昪	bmoa
苄	bmcb
笾	bmvl
砭	bmuf
鳊	bmec
萹	bmcc
忭	bmxb
碥	bmuc	4
褊	bmpc
表	bcah
标	bclx
婊	bcnh
飙	bcqx
镖	bcjx
彪	bchp
裱	bcph
膘	bcox
杓	bclu
鳔	bcex
镳	bcje
骉	bcmm
熛	bchx
摽	bcfx
幖	bcjx
骠	bcmx
藨	bcce
儦	bcre
瀌	bcde
俵	bcrh
飑	bcfv
瘭	bcbx
脿	bcoh
别	bxkd
憋	bxbx
鳖	bxby
瘪	bxbb
蹩	bxbr
癿	bxbv
宾	bngb
斌	bnwg
彬	bnlp
髌	bngb
鬓	bnib
滨	bndb
豳	bnsn
邠	bnbe
缤	bnsb
膑	bnob
殡	bndb
濒	bndr
摈	bnfb
玢	bnwd
傧	bnrb
镔	bnjb
槟	bnlb
并	byek
病	bybb
兵	byqb
冰	bydu
饼	byuk
柄	bylb
丙	byan
禀	bywx
屏	byuk
秉	bypn
炳	byhb	4
蛃	byib	5
昺	byob
摒	byfk
槟	bylb
邴	bybe
栟	bylk
波	body
博	bouc
播	boft
薄	bocc
拨	bofy
伯	borb
铂	bojb
搏	bofc
啵	boky
钵	bojb
勃	boul
驳	bomx
玻	bowy
脖	booz
帛	bobj
剥	bold
跛	bozy
亳	bowq
箔	bovb
柏	bolb
孛	bouz
泊	bodb
钹	bojy
渤	bodl
镈	bojc
僰	boar
菠	bocy
擘	bouu
浡	bodz
舶	bovb
嶓	bost
膊	booc
哱	bokz
砵	boub
卜	boad
踣	bozk
簸	bovy
鹁	boun
檗	boul
鲌	boeb
蕃	boct
艴	bofb
趵	bozu
馞	bohz
袯	bopy
饽	bouz
礴	bouc
欂	bolc
不	buad
部	bule
补	bupb
步	buvp
布	buaj
簿	buvc
钚	bujb
捕	buff
卜	buad
怖	buxj
卟	bukb
晡	buof
埠	butu	4
逋	buzf
堡	burt
哺	bukf
蔀	buce
瓿	bulw
醭	buyn
埔	butf	5
埗	butb
擦	cafx
嚓	cakx
才	clap	5
菜	clcl
踩	clzl
猜	clqo
蔡	clcx
财	clbc
采	clpl	5
材	cllc
裁	clhg	4
彩	clpp	4
睬	clml
偲	clrx
惨	cjxp
餐	cjah
残	cjdg	4
参	cjvp
蚕	cjti
粲	cjam	5
灿	cjhs
骖	cjmp
惭	cjxj
璨	cjwm
黪	cjhp
䅟	cjhp
藏	chcg
仓	chrv	5
舱	chvv
苍	chcv
沧	chdv
鸧	chrn
伧	chrv	4
草	ckcu
槽	cklo
曹	ckao
操	ckfl
糙	ckmk
嘈	ckko
漕	ckdo
艚	ckvo
螬	ckio
侧	cerd
测	cedd
册	cepa
策	cevn
厕	ceid
恻	cexd
岑	cfsj
涔	cfdj
参	cfvp
曾	cgeo
层	cguv
蹭	cgzo
噌	cgko
嶒	cgso
差	iaeg
茶	iacx
查	iald	5
插	iafj
叉	iayd
侘	iarq
茬	iact
镲	iajx
察	iagx
猹	iaqd	5
搽	iafx
槎	ialg
岔	iabs
檫	ialx	5
杈	iali
嚓	iakx	4
碴	iaud	4
姹	ianq
汊	iadi
衩	iapi
锸	iajj
垞	iatq
诧	iayq
馇	iaud
刹	iaxd
喳	iakd	5
蹅	iazd	5
嵖	iasd
拆	ilfi
柴	ilvl
差	ileg
钗	ilji
豺	ilpc
虿	ilwi
侪	ilrq
瘥	ilbg
茝	ilca
产	ijwi
铲	ijji
馋	ijud
缠	ijsl
禅	ijpd
蝉	ijid	4
掺	ijfp
颤	ijwr	5
搀	ijfd
谗	ijyd
浐	ijdi
婵	ijnd
蟾	ijik
澶	ijdd
觇	ijvj
阐	ijmd
躔	ijzt
襜	ijpk	5
谄	ijyj
镡	ijju
刬	ijgd
辿	ijzs
忏	ijxq
巉	ijst
韂	ijck	4
羼	ijuy
廛	ijgt
潺	ijdz
梴	ijlv
孱	ijuz
蒇	ijcg
啴	ijkd
单	ijea
骣	ijmz
镵	ijjt	4
瀍	ijdt
旵	ijos
冁	ijeh
儳	ijrt
唱	ihko
场	ihtp
长	ihpn
常	ihej
厂	ihap
尝	ihev
肠	ihop
畅	ihup
昌	ihoo
偿	ihrv
敞	ihew
娼	ihno
鬯	ihpb
怅	ihxi
倡	ihro
昶	ihyo
猖	ihqo
嫦	ihnj
氅	ihem
伥	ihri
苌	ihci
鲳	iheo
菖	ihco
徜	ihrk
裳	iheh
阊	ihmo
鲿	ihev
惝	ihxk
超	iktk
抄	ikfu
炒	ikhu
朝	ikuo
潮	ikdo
吵	ikku
钞	ikju
巢	ikvg
嘲	ikko
焯	ikhu
晁	ikov
怊	ikxk
绰	iksu
弨	ikgk
耖	ikfu
车	ieaa
扯	iefv
撤	iefw
彻	ierd
掣	ievu
澈	iedw
坼	ieti
尺	ieun
砗	ieui
㬚	ieow
陈	ifed
趁	iftp
臣	ifka
沉	ifdj
辰	ifih
尘	ifat
琛	ifwl
抻	iffu
嗔	ifkb
衬	ifpc
晨	ifoh
称	ifhx
宸	ifgh
谶	ifyg
谌	ifyu
瞋	ifmb
忱	ifxv
梣	iflj	5
煁	ifhu
榇	iflx
龀	ifvb
疢	ifbh
棽	iflj	4
碜	ifup
郴	ifle
成	igvg	4
称	ighx
城	igtg
呈	igkw
乘	igqn
撑	igfu
橙	igld
程	ighw
秤	ighu	5
盛	igim	5
承	igvn
诚	igyg
丞	igla
澄	igdd
逞	igzw
惩	igrx
枨	igli
埕	igtw
骋	igmv	3
铖	igjg
澂	igdw
珵	igww
琤	igwv
塍	igot
偁	igrr
蛏	igit
赪	igtr
噌	igko
酲	igyw
宬	iggg
柽	iglt
瞠	igmt
珹	igwg	2
牚	igey
晟	igog
铛	igjd
憕	igxd
裎	igpw
庱	iggw	4
吃	iiky
池	iidy
持	iifc
赤	iitd
尺	iiun
迟	iizi
齿	iiva
敕	iiuw
痴	iibk
驰	iimy
翅	iiux
耻	iiev	4
嗤	iiki	4
豉	iidy
斥	iipd
螭	iiil
叱	iikb
彳	iipr
蚩	iivi
炽	iihb
笞	iivk
哧	iiki	5
媸	iini
饬	iiul	5
侈	iirx
弛	iigy
褫	iipj
魑	iigl
摛	iifl
鸱	iiun
啻	iiwk
瘛	iibx
漦	iiwu
墀	iitn
茌	iicu
匙	iiob
眵	iimx
篪	iivj
傺	iirx
踟	iizk
胣	iioy
瓻	iixw
痓	iibt
冲	isdv
重	ispa
充	iswe
虫	isvd
宠	isgb
崇	issx
铳	isje
舂	isaj
憧	isxl
摏	isfj
艟	isvl
翀	isxv
忡	isxv
茺	isce
涌	isdy
种	ishv
珫	iswe
漴	isdx
㳘	isde
抽	ibfy
丑	ibva
臭	ibzq
愁	ibhx
瞅	ibmh
仇	ibrj	4
筹	ibvc	4
稠	ibhk
酬	ibyv
雠	ibru
俦	ibrc	5
绸	ibsk
畴	ibtc
瘳	ibbp
惆	ibxk
杻	ibli
帱	ibjc	5
椆	iblk
犨	ibrn
踌	ibzc
侴	ibrd
出	iuva
处	iuwb
除	iuex
初	iupd
楚	iulr
厨	iuic
触	iuei
褚	iupo
杵	iulu
储	iuro
锄	iujl
怵	iuxu
雏	iuea
橱	iulc
畜	iuwt
黜	iuhi
刍	iuea
础	iuui
俶	iury
楮	iulo
矗	iuuv
亍	iuev
滁	iudx
绌	iusi
樗	iulk
憷	iuxr
斶	iuji
搐	iuft
摴	iufk
躇	iuzo
蜍	iuix
濋	iudr
蹰	iuzc
䝙	iupx
䢺	iuie
琡	iuwy
欻	iwhr
踹	iyze
揣	iyfe
搋	iyfj
啜	iyky
穿	irgy
传	irrv
船	irvk
川	irpa
串	iraa
氚	irqi
喘	irke
钏	irji
舛	irxa
椽	irln
遄	irze
床	idgl
创	idrd
窗	idgw
闯	idmm
疮	idbv
怆	idxv
幢	idjl
噇	idkl
吹	ivkr
锤	ivji
捶	ivfi
垂	ivpa
炊	ivhr
槌	ivlv
圌	ivwe
棰	ivli
倕	ivri
陲	ivei
纯	ipst
蠢	ipii
春	ipao
唇	ipik
醇	ipyz
椿	iplo
淳	ipdz
蝽	ipio
鹑	ipwn
莼	ipct
瑃	ipwo
䲠	ipeo
堾	ipto
戳	ioxg
啜	ioky
辍	ioiy
绰	iosu
龊	iovr
踔	iozu
逴	iozu
惙	ioxy
次	cidr
此	civb
词	ciyk
刺	ciad
赐	cibw
磁	cius
茨	cicr
呲	cikb
辞	ciqu
雌	civa
瓷	cidw
祠	cipk
慈	ciex
泚	cidb
疵	cibb
伺	cirk
玼	ciwb
糍	cims
跐	cizb
差	cieg
茈	cicb
兹	cies
佽	cirr
鹚	cien
莿	cicd
从	csrr
葱	cscx
聪	csex
丛	csra
琮	cswx
悰	csxx
骢	csmx	5
枞	cslr
璁	cswx	4
淙	csdx
熜	cshx
匆	cspd
囱	cspw
苁	cscr
凑	cbdt
腠	cbot
辏	cbit
粗	cumq
醋	cuyo
促	curr
簇	cuvd
蹙	cuxr
蹴	cuzy
猝	cuqu
殂	cudq
徂	curq
卒	cuwu
蔟	cucd
窜	crgi
蹿	crzi
汆	crru
篡	crvv
爨	crph
攒	crfr
撺	crfi
镩	crji
催	cvra
崔	cvsa
脆	cvov
翠	cvxu
啐	cvku
萃	cvcu
摧	cvfa
淬	cvdu
粹	cvmu
毳	cvmm
璀	cvwa
悴	cvxu
瘁	cvbu
漼	cvda
缞	cvsh
榱	cvlh
寸	cpad
存	cpaz
村	cplc
邨	cpte
皴	cpvy
忖	cpxc
错	cojo
搓	cofg
挫	coft
措	cofo
锉	cojt
厝	coio
撮	cofy
蹉	cozg
矬	cout
痤	cobt
瑳	cowg
嵯	cosg
鹾	colg
磋	coug
脞	coot
棤	colo
莝	coct
大	daan
打	dafd
答	davk
达	dazd	4
搭	dafk
哒	dakd
嗒	dakk
妲	dand
鞑	dacd
怛	daxd
沓	dauo
炟	dahd
跶	dazd
笪	davd
耷	dade
靼	dacd
垯	datd
溚	dadk
瘩	dabk
褡	dapk
荙	dacd
鿎	daud	5
带	dlaj
代	dlrg	5
待	dlrc
呆	dlkl
戴	dlbg
贷	dlrr
袋	dlrh
黛	dlre	4
逮	dlzl	4
岱	dlrs
殆	dldk	5
迨	dlzk
呔	dlkt
歹	dlax	4
玳	dlwg
傣	dlru
怠	dlvx
绐	dlsk
埭	dltl
大	dlan
轪	dlid
骀	dlmk
叇	dlel	5
垈	dlrt
但	djrd
单	djea	4
蛋	djvi
弹	djgd
淡	djdh
丹	djpa
氮	djqh
胆	djod	4
担	djfd
旦	djoa
啖	djkh
掸	djfd
澹	djdk
亶	djwd
石	djak
诞	djyv
惮	djxd	5
耽	djev	4
儋	djrk
聃	djer
殚	djdd
疍	djvd
箪	djvd
憺	djxk
膻	djod	5
瘅	djbd
眈	djmv	5
萏	djcj
赕	djbh
郸	djee
疸	djbd
当	dhea
党	dhee	4
档	dhld
挡	dhfd
裆	dhpd
荡	dhct
铛	dhjd
宕	dhgk
砀	dhup
凼	dhua
珰	dhwd
谠	dhye	5
菪	dhck
垱	dhtd
筜	dhvd
到	dkvd
道	dkzm
刀	dkvp
倒	dkrd
岛	dkps
导	dkvc
盗	dkdm
叨	dkkd
氘	dkqa
稻	dkhj
捣	dkfs
悼	dkxu
纛	dkdx
蹈	dkzj
祷	dkpc
捯	dkfd
忉	dkxd
帱	dkjc
舠	dkvd
鱽	dked
的	debu
得	derc
地	dety
德	derx
锝	dejc
嘚	dekc
得	dzrc
嘚	dzkc
扽	dfft
等	dgvc
灯	dghd
登	dgvd
邓	dgye
蹬	dgzd
凳	dgdj
瞪	dgmd
噔	dgkd
镫	dgjd
戥	dgog
磴	dgud
嶝	dgsd
澄	dgdd
璒	dgwd
地	dity
第	divp
低	dird
滴	didk
底	digd
帝	diwj	4
迪	dizy
敌	diqw
蒂	dicj
抵	difd	5
笛	divy
递	dizd
狄	diqh
弟	diep
镝	dijk
氐	diud
嫡	dink
堤	ditr
骶	digd
棣	dill
邸	diue	5
的	dibu	4
碲	diuj
嘀	dikk
睇	dimd
禘	dipj
谛	diyj
籴	dirm
砥	diud
鞮	dicr
涤	didx
荻	dich
菂	dicu	4
娣	dind	4
诋	diyd
觌	diuj
羝	died	4
柢	dild
翟	dixa
杕	dild
髢	diiy
坻	ditd	5
茋	dicd	5
缔	disj	5
踶	dizr
媂	dinj
提	difr
蹢	dizk
玓	diwu
䃅	diud
䗖	diij
嗲	dwkx
点	dmve
店	dmgk
电	dmav
垫	dmft
碘	dmub
殿	dmuy
颠	dmur
典	dmab
滇	dmdb
甸	dmpt
掂	dmfk
簟	dmvu
癫	dmbr
巅	dmsr
奠	dmed
靛	dmqr
钿	dmjt
踮	dmzk
佃	dmrt
淀	dmdr
玷	dmwk
惦	dmxk
坫	dmtk
癜	dmby
扂	dmhk
阽	dmek
琔	dmwr
掉	dcfu
调	dcyk
吊	dckj
叼	dckd
钓	dcju
雕	dcva
刁	dcva
貂	dcpk	5
凋	dcdk	4
鲷	dcek	5
碉	dcuk	4
铫	dcjv
窎	dcgn
铞	dcjj
汈	dcdd
跌	dxzu
爹	dxbx
叠	dxyq
碟	dxul
蝶	dxil
迭	dxzu
谍	dxyl
牒	dxpl
昳	dxou
鲽	dxel
喋	dxkl
堞	dxtl
瓞	dxgu
耋	dxut
垤	dxtt
绖	dxst
楪	dxll
蹀	dxzl
定	dygr
顶	dydr
丁	dyav
盯	dymd	3
订	dyyd
钉	dyjd
鼎	dymv	5
叮	dykd
碇	dyur
町	dytd	4
腚	dyor
锭	dyjr
玎	dywd
啶	dykr
酊	dyyd
仃	dyrd
疔	dybd
耵	dyed	2
萣	dycr
丢	dqpv
铥	dqjv
懂	dsxv	5
动	dsel
东	dsad
洞	dsdk
冻	dsdd
冬	dswd
董	dscv
栋	dsld
咚	dskd
氡	dsqd
侗	dsrk
鸫	dsdn
胴	dsok	5
峒	dssk	4
恫	dsxk	4
硐	dsuk
岽	dssd	5
垌	dstk
胨	dsod	4
都	dbue
斗	dbdu
抖	dbfu
豆	dbaa
逗	dbzd
兜	dbpe
痘	dbbd
陡	dber
窦	dbgd
读	dbyd
蔸	dbce
蚪	dbiu
钭	dbju
篼	dbve
读	duyd
度	dugy
都	duue
赌	dubo
毒	duam	4
堵	duto
杜	dult
独	duqi
渡	dudy
督	duum
肚	duot
镀	dujy
笃	duvm
嘟	duke
蠹	duai
睹	dumo
妒	dunh
犊	dund
渎	dudd
椟	duld
牍	dupd
阇	dumo
厾	duvv	5
芏	duct
黩	duhd
髑	dugi
端	drle
段	drpy
短	drud
断	drvj
椴	drly
锻	drjy
缎	drsy
耑	drse
煅	drhy
塅	drty
簖	drvj
瑖	drwy
对	dvyc
队	dver
怼	dvyx
堆	dvta
兑	dvee
碓	dvua
祋	dvpy
吨	dpkt
蹲	dpzc
盾	dppm
炖	dpht
顿	dptr
惇	dpxz
墩	dptw	5
遁	dpzm
钝	dpjt
敦	dpww	4
趸	dpwr
囤	dpwt
盹	dpmt
沌	dpdt
镦	dpjw
礅	dpuw
蹾	dpzw
砘	dput
多	doxx
躲	doul
夺	dodc
剁	dojd
朵	dojl
堕	doet
度	dogy
舵	dovb
跺	dozl
铎	doja
哆	dokx
踱	dozy
惰	doxo
垛	dotl
咄	doki
掇	dofy
埵	doti
亸	dowd
驮	domd
哚	dokl
剟	doyd
裰	dopy
饳	doui
㙍	doty
额	eegr
恶	eeyx
呃	eekv
俄	eerg
饿	eeug
鹅	eewn
厄	eeiv
讹	eeyb
鳄	eeek
鄂	eeke
娥	eeng
欸	eevr
蛾	eeig
颚	eekr
腭	eeok	5
锇	eejg
扼	eefv
阿	eeek
轭	eeiv
莪	eecg
遏	eezv
谔	eeyk
屙	eeuk
萼	eeck
锷	eejk
鹗	eekn
愕	eexk
峨	eesg
涐	eedg
垩	eeyt
崿	eesk	4
噩	eeaa
哦	eekg
婀	eenk
姶	eenk
苊	eecv
堨	eetv
欸	eivr
嗯	enkx
恩	enwx
摁	enfx
蒽	encx
嗯	egkx
而	eraa	4
二	eraa
儿	erpv
耳	eraa
尔	erex
贰	errg
饵	erue
迩	erzx
铒	erje
珥	erwe
鸸	eren
洱	erde
鲕	eree
耏	erep	5
陑	eree
咡	erke
发	favy
法	fadv
伐	farg
罚	fasd
阀	famg
乏	fapv
筏	favg
珐	fawv
垡	fart
砝	fauv
反	fjpy
饭	fjuy	4
翻	fjfx
犯	fjqv
范	fjcv
泛	fjdf
凡	fjjd
番	fjpt
烦	fjhr
返	fjzy
帆	fjjf
藩	fjct	5
繁	fjmx	4
梵	fjlf	5
樊	fjld
蕃	fjct	4
贩	fjby
钒	fjjf
矾	fjuf
幡	fjjt
燔	fjht
氾	fjdv
蘩	fjcx
璠	fjwt
蹯	fjzt
畈	fjty	5
墦	fjtt
放	fhfw
方	fhwp
防	fhef
房	fhhf
仿	fhrf
坊	fhtf
芳	fhcf
访	fhyf
钫	fhjf
昉	fhof
纺	fhsf	4
枋	fhlf
鲂	fhef
妨	fhnf
肪	fhof
舫	fhvf	5
蚄	fhif
邡	fhfe
牥	fhnf
非	fzaa
费	fzfr
飞	fzvd
肺	fzoa	5
废	fzgy
肥	fzob	4
菲	fzcf	5
妃	fznj
匪	fzkf	4
绯	fzsf
斐	fzfx
吠	fzkq
沸	fzdf
啡	fzkf
霏	fzyf
榧	fzlf
扉	fzhf
腓	fzof	4
淝	fzdb
蜚	fzfi
朏	fzoi	5
镄	fzjr
诽	fzyf
痱	fzbf
翡	fzfx
狒	fzqf
鲱	fzef
悱	fzxf
芾	fzca	4
棐	fzfl
剕	fzfd
篚	fzvf
分	ffbd
粉	ffmd	4
份	ffrd
坟	fftx
芬	ffcd
粪	ffmb
焚	fflh
汾	ffdd
酚	ffyd
忿	ffbx
愤	ffxr
奋	ffdt
偾	ffrr	5
纷	ffsd
氛	ffqd
棻	ffcl
棼	ffld
鲼	ffer
瀵	ffdb
玢	ffwd
翂	ffxd
吩	ffkd
坋	fftd
鼢	ffjd	5
豮	ffar	4
风	fgjx
封	fgtc
冯	fgdm
峰	fgsf
疯	fgbx
缝	fgsf
奉	fgaa
逢	fgzf
锋	fgjf
丰	fgaa
凤	fgjy
枫	fglx
蜂	fgif	4
俸	fgrf
沣	fgdf	4
讽	fgyx
葑	fgcc
沨	fgdx
烽	fghf	5
酆	fgae
唪	fgkf
砜	fgux
崶	fgsc
赗	fgbm
浲	fgdf	5
佛	forf
否	fbbk
缶	fbwa
负	fuer	4
附	fuec
服	fuoy
副	fuad
付	furc	3
福	fupt
府	fugc
复	fupw	5
富	fugt
夫	fuan
赴	futb
父	fubx
扶	fuff
氟	fuqf
赋	fubg
弗	fuva
符	fuvc
伏	furq
傅	furc	5
幅	fujt
敷	fufw	5
芙	fucf	4
斧	fubj	5
釜	fuba
腹	fuow	4
浮	fudz
辅	fuif
妇	funa
甫	fuad
覆	fuxw	3
抚	fufw
拂	fuff
腐	fugr
缚	fusc
俘	furz
俯	furc	4
腑	fuoc
辐	fuit
孚	fupz
孵	fulz
佛	furf
阜	fupu
凫	fupj	5
肤	fuof	5
蝠	fuit
祓	fupy
脯	fuof
芣	fucb
黼	fuyf
鄜	fuge
馥	fuhw	5
涪	fudk
桴	fulz	4
黻	fuyy
苻	fucc
拊	fufc
麸	fumf
郛	fupe
玞	fuwf	4
簠	fuvm
绂	fusy
宓	fugb
跗	fuzc
茯	fucq
赙	fubc
莩	fucz	5
趺	fuzf
茀	fucf
蝮	fuiw	3
稃	fuhz	4
匐	fupt
罘	fusb
驸	fumc
怫	fuxf	4
呋	fukf
袱	fupq	5
洑	fudq
榑	fulc
鲋	fuec
菔	fucy	4
滏	fudf
芾	fuca	5
咐	fukc
幞	fujn
艴	fufb	4
绋	fusf
蚨	fuif	4
韨	fuwy
琈	fuwz	3
垺	futz
讣	fuyb
蜉	fuiz	5
砆	fuuf
㕮	fukx
㳇	fudx
尬	gaaj
嘎	gakg
噶	gakg
伽	gark
尕	ganx
钆	gajv
咖	gakk
旮	gajo
尜	gaax
轧	gaiv
戛	gaag
该	glyr
改	gljw
盖	glem
钙	gljg
概	gllj
丐	glav
垓	gltr
陔	gler
溉	gldj
赅	glbr	4
荄	glcr
戤	glng
晐	glor	5
感	gjkx
干	gjau
敢	gjvw
肝	gjog
杆	gjlg
赶	gjtg
甘	gjaa
柑	gjlg
淦	gjdj	4
赣	gjlr
苷	gjcg
擀	gjfg
绀	gjsg
竿	gjvg
尴	gjam
橄	gjlw
秆	gjhg
酐	gjyg
鳡	gjex
玕	gjwg
矸	gjug
泔	gjdg	5
坩	gjtg
旰	gjog
疳	gjbg
澉	gjdw
虷	gjig
㽏	gjdg	3
刚	ghgd
岗	ghsx
港	ghdv
杠	ghlg
缸	ghfg
钢	ghjx
纲	ghsx
肛	ghog
冈	ghax
罡	ghsv
矼	ghug
扛	ghfg
戆	ghlx
冮	ghdg
堽	ghtv
筻	ghvg
㭎	ghlx
鿍	ghta
高	gkwk
搞	gkfk
稿	gkhk
告	gkpk
膏	gkwo
糕	gkme
镐	gkjk
诰	gkyk
皋	gkbu
锆	gkjk
郜	gkge
缟	gksk
睾	gkpu
藁	gkcl
杲	gkol
篙	gkvk
槔	gklu
羔	gkee
槁	gklk
筶	gkvk
个	gera
各	gewk
哥	geak
歌	gegr
格	gelk
割	gegd
隔	geea
咯	gekk
搁	gefk
戈	gead
葛	gecv
阁	gemk
铬	gejk
鸽	gern
镉	geja
革	geca
嗝	geka
硌	geuk
膈	geoa
鬲	geaa
胳	geok
蛤	geik
骼	gegk
盖	geem	5
舸	gevk
圪	gety	4
疙	geby
饹	geuk
滆	geda
袼	gepk
哿	gelk
仡	gery
合	gerk
虼	geiy
塥	geta
给	gzsk
跟	gfzh
根	gflh
哏	gfkh
艮	gfvh
亘	gfad
茛	gfch
更	ggan
梗	gglg
羹	gged
耿	ggeh
耕	ggfj
庚	gggn
埂	ggtg
哽	ggkg
赓	gggr
暅	ggod
鲠	ggeg
浭	ggdg
颈	ggvr
绠	ggsg
鹒	gggn
共	gscb	4
供	gsrb
弓	gsvv
工	gsaa
公	gsbv
宫	gsgk
攻	gsgw	5
功	gsgl
拱	gsfb	4
龚	gslb
汞	gsgu
贡	gsgr
恭	gscd	5
巩	gsgf
躬	gsug
肱	gsov
觥	gsee
蚣	gsiv
珙	gswb
䢼	gsce
硔	gsub
狗	gbqk
够	gbjx
勾	gbpv
钩	gbjv
购	gbbv
沟	gbdv
苟	gbck
构	gblv
垢	gbtk
篝	gbvr	5
遘	gbzr
彀	gbuy
诟	gbyk
觏	gbaj
媾	gbnr
枸	gblk
姤	gbnk
雊	gbja
鞲	gbcr
句	gbpk
笱	gbvk	4
缑	gbsd
佝	gbrk
岣	gbsk
耇	gbuk
故	guuw
股	guoy
古	guuk
鼓	guuy
谷	gubk
骨	guao
顾	guir
钴	gujk	4
雇	guha
孤	guzg
固	guwk
菇	guck
姑	gunk
蛊	guim
箍	guvj
估	gurk
咕	gukk
瞽	guum
沽	gudk
菰	gucg
诂	guyk
辜	guuu
毂	guuy	4
榖	guuy	5
觚	gueg
贾	guxr
酤	guyk	4
锢	gujk	5
崮	gusk	5
堌	gutk
蛄	guik
罟	gusk	3
汩	gudo
鹘	gugn
轱	guik	5
牯	gunk
嘏	guuy
梏	gulk
鲴	guek
呱	gukg
鹄	gugn
痼	gubk
鸪	guun
羖	guey	3
瀔	gudy
臌	guoy	3
馉	guuo
牿	gunk
蓇	guco
挂	gwft
刮	gwqd
瓜	gwpn
卦	gwtb
寡	gwgd
呱	gwkg
剐	gwkd
胍	gwog
褂	gwpb
栝	gwlk
鸹	gwqn
诖	gwyt
怪	gyxt
乖	gyqb
拐	gyfl
夬	gyvn
掴	gyfy
管	grvg
关	gret
官	grga	3
观	gryj
馆	grug
冠	grgc	5
灌	grda	5
罐	grfa
棺	grlg
贯	grvr
惯	grxr
毌	grva	4
倌	grrg
掼	grfr
瓘	grwa
祼	grpg
鹳	grcn
琯	grwg
鳏	gred	4
筦	grve
爟	grha
盥	grpm
涫	grdg
纶	grsb
莞	grce
鳤	greg	2
蒄	grcc
光	gdee
广	gdwp
逛	gdzw
咣	gdke
洸	gdde
桄	gdle
犷	gdqg
胱	gdoe
垙	gdte
珖	gdwe
贵	gvvr
归	gvaa
鬼	gvpv	4
柜	gvlj
跪	gvzv
轨	gvij
硅	gvut
龟	gvev	4
桂	gvlt
圭	gvtt
规	gvfj
诡	gvyv
瑰	gvwv
珪	gvwt
簋	gvvm
癸	gvvt
妫	gvnw
邽	gvte
鲑	gvet	5
刿	gvsd
晷	gvok
闺	gvmt	5
桧	gvlv
刽	gvrd
鳜	gver
鬶	gvfa
宄	gvgj
庋	gvgy
匦	gvkj
皈	gvby
炅	gvoh
姽	gvnv
筀	gvvt
滚	gpdh
棍	gplb
鲧	gpex
辊	gpib
衮	gpwh
绲	gpsb
磙	gpuh
过	gozc
国	gowy	5
锅	gojn
郭	gowe
果	goan	4
裹	gowh
粿	gomg
虢	gopj
椁	golz
馘	goeg
腘	gooy
掴	gofy
馃	goug	5
崞	gosz
呙	gokn
帼	gojy	4
蝈	goiy
聒	goek
蜾	goig
涡	godn
埚	gotn
哈	hakk
蛤	haik
铪	hajk
还	hlzb
海	hldm
嗨	hlkm	4
害	hlgk
氦	hlqr	4
孩	hlzr
亥	hlwr
嗐	hlkk	5
醢	hlym
骇	hlmr
骸	hlgr
咳	hlkr	5
咍	hlkk	4
胲	hlor	5
含	hjrk
喊	hjkg
汉	hjdy
韩	hjuw
汗	hjdg
寒	hjgd
邯	hjge
函	hjla
憨	hjgx
焊	hjhg	4
旱	hjog	4
焓	hjhk
悍	hjxg
罕	hjgg
涵	hjdh
翰	hjux
憾	hjxx
酣	hjyg
撼	hjfx	5
瀚	hjdx
颔	hjrr
晗	hjok
捍	hjfg	4
蚶	hjig
鼾	hjzg	5
扞	hjfg	5
菡	hjch
邗	hjge
琀	hjwk
暵	hjon
犴	hjqg
顸	hjgr
撖	hjfw	4
浛	hjdk
虷	hjig	5
㘎	hjkw
垾	hjtg
崡	hjsh
嵅	hjsk
蔊	hjcg
行	hhrd
杭	hhlj
航	hhvj
夯	hhdl
沆	hhdj
颃	hhwr
绗	hhsd
巷	hhcv
吭	hhkj
好	hknz
号	hkkv
薅	hkcc
耗	hkfm
浩	hkdk
豪	hkwn	5
壕	hkth	4
嚎	hkkh
郝	hkte	5
蚝	hkim
皓	hkbk
蒿	hkck
毫	hkwm
昊	hkot
皞	hkbu
濠	hkdh
灏	hkdr
貉	hkpk
鄗	hkwe	4
淏	hkdt
嗥	hkku
颢	hkor
镐	hkjk
嚆	hkkk
和	hehk
喝	hekv
核	helr
盒	herm
何	herk
合	herk
河	hedk
呵	hekk	4
贺	helr
鹤	hedn
赫	heti
荷	heck	4
禾	heqn
阖	hemm
龁	hevy
嗬	hekk	5
褐	hepv	4
曷	heov
颌	herr
郃	here
盍	hetm
涸	hedk
诃	heyk
鹖	heon
劾	hewl
貉	hepk
纥	hesy
盉	hehm
壑	heat
吓	hekx
龢	herh
熇	hehk
菏	heck	5
饸	heuk
翮	heax
翯	hexk
阂	hemr
垎	hetk
隺	heda
鞨	hecv	5
黑	hzae
嘿	hzke
很	hfrh
恨	hfxh
狠	hfqh
痕	hfbh
哼	hgkl
横	hglb
恒	hgxd
衡	hgrd
亨	hgwl
珩	hgwd
桁	hgld
蘅	hgcd
鸻	hgrn	4
姮	hgnd
行	hgrd	5
堼	hgtt
红	hssg
烘	hshb
宏	hsgv
哄	hskb
轰	hsiy
虹	hsig
洪	hsdb
鸿	hsdn
薨	hscb
弘	hsgv
泓	hsdv
纮	hssv	4
闳	hsmv
吽	hskn
竑	hslv	5
黉	hseb
翃	hsax
訇	hspk
蕻	hscb
唝	hskr
讧	hsyg
荭	hscg
玒	hswg
谼	hsbb
后	hbpk
厚	hbiz
吼	hbkk
侯	hbrd	5
猴	hbqd
候	hbrd	4
喉	hbkd
齁	hbzk
鲎	hbey
堠	hbtd
垕	hbht
逅	hbzk
糇	hbmd
瘊	hbbd
骺	hbgk
篌	hbvd
郈	hbhe
鲘	hbek
壶	huuy
户	hudu
湖	hudo
胡	huuo	3
虎	huaj
乎	hupv
糊	humo
和	huhk
互	huaa
呼	hukh
护	hufh
沪	hudh
忽	huwx
弧	hugg
狐	huqg	4
唬	hukj
核	hulr
斛	hueu
瑚	huwo
瓠	hudg	5
縠	huuy	4
笏	huvw	5
鹄	hugn
鄠	huye
葫	huco
煳	huho	4
扈	huhb
烀	huhh
祜	hupk
怙	huxk
惚	huxx
觳	huuy	5
鹘	hugn
岵	husk
唿	hukx
冱	hudh
鹱	huny
鳠	huey
蝴	huio	5
琥	huwj
淴	hudx
浒	hudu	5
鹕	huun
醐	huyo
槲	hulu
滹	hudh	4
囫	huww	4
戽	huhu
嫭	hunh
轷	huih
猢	huqo
昈	huoh
昒	huow
花	hwcb
化	hwrb
画	hwaa
话	hwyk
滑	hwdo
华	hwru
划	hwgd
哗	hwku
桦	hwlu
婳	hwnh
骅	hwmu
猾	hwqo
砉	hwfk
铧	hwju
觟	hwet
坏	hytb
怀	hyxb
淮	hyda
踝	hyzg
槐	hylv
徊	hyrk
换	hrfd
还	hrzb
环	hrwb
患	hrix
幻	hrsv
缓	hrsy
欢	hryr
唤	hrkd
嬛	hrnh
桓	hrld
寰	hrgh
浣	hrde
焕	hrhd
獾	hrqa
涣	hrdd
洹	hrdd
圜	hrwh
豢	hrdn
郇	hrxe
鲩	hree
奂	hred
宦	hrgi
萑	hrca
逭	hrzg
擐	hrfh
缳	hrsh
鹮	hrsn
澴	hrdh
镮	hrjh
漶	hrdx
鬟	hrih
痪	hrbd
貆	hrpd
峘	hrsd
锾	hrjy
㬊	hroy
荁	hrcd
黄	hdcb
慌	hdxh
皇	hdbw
晃	hdoe
荒	hdcv
谎	hdyh
簧	hdvb	5
煌	hdhw	4
篁	hdvw	4
凰	hdjw
幌	hdje
蝗	hdiw	5
恍	hdxe
滉	hdde
遑	hdzw
潢	hddb	4
璜	hdwb	4
湟	hddw	5
肓	hdwo
锽	hdjw	4
徨	hdrw	4
惶	hdxw
鳇	hdew	5
隍	hdew
喤	hdkw
艎	hdvw
癀	hdbb
蟥	hdib	3
媓	hdnw
瑝	hdww	5
㿠	hdbe
会	hvrv
回	hvwk
灰	hvah
毁	hvjy
汇	hvdk
惠	hvax
茴	hvck
绘	hvsv
挥	hvfi
辉	hvei
悔	hvxm
慧	hvfx
喙	hvkn
晖	hvoi
烩	hvhv
讳	hvyw
恢	hvxh
徽	hvrw
卉	hvua
虺	hvai
蕙	hvcx
秽	hvhx
麾	hvgm
晦	hvom
诲	hvym
隳	hved
恚	hvtx
荟	hvcv
浍	hvdv
洄	hvdk
翚	hvxi
贿	hvbo
翙	hvsx
咴	hvkh
珲	hvwi
蛔	hvik
彗	hvfa
哕	hvkx
诙	hvyh
袆	hvpw
橞	hvlx
蟪	hvix
桧	hvlv
溃	hvdr
烠	hvho
硊	hvuv
㧑	hvfw
混	hpdb
魂	hpev
婚	hpno	5
荤	hpci
浑	hpdi
昏	hpuo	4
溷	hpdn
珲	hpwi
阍	hpmo
馄	hpub
诨	hpyi
惛	hpxo
碈	hpuo
或	hoag
活	hodk
火	hodr
货	horr
获	hocq
霍	hoya
嚯	hokh
祸	hopn
豁	hogk
伙	horh
和	hohk
惑	hohx
镬	hojy
藿	hoch
钬	hojh
濩	hody
夥	hogx
嚄	hoky
蠖	hoiy
攉	hofh
漷	hode
劐	hocd
耠	hofk
佸	hork
锪	hojx
㸌	hohh
及	jipn
即	jive
级	jisj
机	jilj
既	jivv	5
集	jirl
记	jiyj
鸡	jiyn
极	jilj
几	jipv
季	jihz	4
肌	jioj
基	jiqt	4
急	jiex	5
系	jipx
继	jism
挤	jifq
计	jiyu
剂	jiwd
给	jisk	4
寄	jigk	4
姬	jina
技	jify
祭	jipx
吉	jiuk
寂	jigy
籍	jivo
击	jiaa
纪	jisj
忌	jijx
己	jivv
积	jihb	3
暨	jijd
辑	jiie
脊	jido	5
疾	jibd	4
戟	jiug
箕	jivb
激	jidw	5
济	jidq
矶	jiuj
叽	jikj
迹	jizy
饥	jiuj
绩	jisr
冀	jibb
棘	jian
藉	jico	5
际	jiex
稷	jihw	2
妓	jiny
汲	jidj
蓟	jicd	5
伋	jirj	5
赍	jiur	5
亟	jila
髻	jiik
殛	jida
鲫	jiee	5
伎	jiry	4
稽	jiho	5
偈	jirv
畸	jitk	5
霁	jiyq	5
圾	jitj
嫉	jind
讥	jiyj
奇	jidk
笈	jivj
骥	jimb
嵴	jiso
唧	jike
齑	jiwa
乩	jivv
戢	jikg
玑	jiwj	4
畿	jitg	4
芰	jicy	4
嵇	jihs
洎	jidz
罽	jisd
笄	jivk
楫	jile
羁	jism
跻	jizq
麂	jigj	4
垍	jitz
姞	jink
荠	jicq
蕺	jicg	4
屐	jiuy
跽	jizx
觊	jisj
漈	jidx
悸	jixz
缉	jise	5
剞	jidd
鲚	jieq
觭	jiek
佶	jirk
掎	jifk
岌	jisj
惎	jiqx	4
耤	jifo	5
虮	jiij
芨	jicj	5
瘠	jibo
期	jiqo
蹐	jizo
犄	jink	4
穄	jihx
堲	jijt
蒺	jicd	4
墼	jiit
瀱	jidd
鹡	jidn
鱾	jiej	4
徛	jirk	3
枅	jilk
加	jwlk
家	jwgn
假	jwry
价	jwrj
甲	jwaa
架	jwll
夹	jwan
贾	jwxr
嫁	jwnj
佳	jwrt
钾	jwjj
嘉	jwuk
伽	jwrk
驾	jwlm
痂	jwbk
镓	jwjj
颊	jwjr
荚	jwcj
枷	jwlk
迦	jwzk
葭	jwcy
岬	jwsj	4
珈	jwwk
斝	jwku
笳	jwvk
郏	jwje
瘕	jwby
铗	jwjj
戛	jwag
稼	jwhj
浃	jwdj
茄	jwck
胛	jwoj	5
槚	jwlr
跏	jwzk
蛱	jwij
袈	jwlh
恝	jwfx
泇	jwdk
间	jmmo
见	jmav
件	jmrn	5
键	jmjj
剑	jmrd
兼	jmen	4
建	jmza
减	jmdg
煎	jmee	5
捡	jmfa
箭	jmvd	5
剪	jmed
肩	jmho
简	jmvo
尖	jmad
舰	jmvj
贱	jmbg
健	jmrj
碱	jmug
歼	jmdq
茧	jmci	4
监	jmam
荐	jmcz
溅	jmdg	5
渐	jmdj
拣	jmfd
检	jmla
僭	jmro
谏	jmyj
奸	jmng
坚	jmat
鉴	jmaj
笺	jmvg	4
涧	jmdo
践	jmzg
蹇	jmgr
艰	jmyh
翦	jmex
菅	jmcg
俭	jmra
柬	jman
缄	jmsg
腱	jmoj	4
笕	jmvj
缣	jmsj
锏	jmjo
睑	jmma
戋	jmad	5
鞬	jmcj
謇	jmgk
湔	jmdd	4
踺	jmzj
犍	jmnj
裥	jmpo
槛	jmlm
蒹	jmcj	5
搛	jmfj
鲣	jmet
枧	jmlj
戬	jmyg	4
鹣	jmen
楗	jmlj
暕	jmoj
谫	jmyd	5
毽	jmmj	5
趼	jmzk
篯	jmvg	3
饯	jmug
鞯	jmcz
牮	jmrn	4
鳒	jmej
将	jddc	4
讲	jdyj
奖	jddd
酱	jddy
姜	jden
江	jddg
降	jdea
蒋	jdcc
僵	jdra
匠	jdkj
桨	jddl
浆	jddu	5
犟	jdgn
绛	jdsa
疆	jdga
缰	jdsa
鳉	jdec
豇	jddg
洚	jdda
强	jdgi
耩	jdfr
弶	jdgx
虹	jdig
糨	jdmi
礓	jdua
茳	jdcg
膙	jdoi
叫	jcka
交	jcwx
较	jcix
教	jcuw
脚	jcoe
角	jcey
胶	jcox	4
浇	jcde
缴	jcsw
焦	jcre
搅	jcfj
嚼	jckc
窖	jcgk
椒	jcly
娇	jcnq
绞	jcsx
跤	jczx
鲛	jcex
轿	jciq
矫	jcuq	4
剿	jcid	5
蛟	jcix
徼	jcrw
骄	jcmq
礁	jcue
饺	jcux
蕉	jcce
铰	jcjx
狡	jcqx
皎	jcbx
郊	jcwe
湫	jcdh
姣	jcnx
酵	jcyz
滘	jcdk
校	jclx
鹪	jcrn
醮	jcye
皦	jcbw	4
觉	jcej
敫	jcbw	5
艽	jccj
茭	jccx
峤	jcsq
佼	jcrx
璬	jcww
燋	jche
侥	jcre
斠	jcau
皭	jcbc
峧	jcsx	5
藠	jccb
噍	jcke
漖	jcdw
僬	jcre
恔	jcxx
䴔	jcwn
届	jxuy
界	jxtj
接	jxfn
借	jxro
皆	jxbb
解	jxen
节	jxce
姐	jxnq
街	jxrd
结	jxsk
截	jxag
杰	jxle
劫	jxtl	4
戒	jxag
阶	jxej
揭	jxfv
介	jxra	4
蚧	jxij
洁	jxdk
捷	jxfr
芥	jxcj
藉	jxco
嗟	jxkg	4
诘	jxyk
羯	jxev
桀	jxxl
竭	jxlv
价	jxrj	5
桔	jxlk
颉	jxur
疖	jxbe
孑	jxva
诫	jxyg
婕	jxnr
玠	jxwj
疥	jxbj
睫	jxmr
碣	jxuv
絜	jxfx
劼	jxul	5
秸	jxhk
拮	jxfk
檞	jxln
骱	jxgj
湝	jxdb
楷	jxlb
蜐	jxil
鲒	jxek
讦	jxyg
喈	jxkb	5
悈	jxxg
褯	jxpj
岊	jxbs
㛃	jxfn
进	jnzj
近	jnzj
仅	jnry
金	jnra
斤	jnpa
今	jnrv
尽	jnid	4
劲	jnvl	5
紧	jnax
晋	jnyo
禁	jnlx
筋	jnvl	4
津	jnda
巾	jnaa
锦	jnjj
浸	jndy
堇	jnca
谨	jnya
靳	jncj
槿	jnla
衿	jnpj
瑾	jnwa
烬	jnhj	5
襟	jnpx
矜	jnvj
瑨	jnwo
噤	jnkx
溍	jndo
缙	jnso
觐	jncj
祲	jnpy
妗	jnnj
馑	jnua
浕	jndj
赆	jnbj
荩	jncj
殣	jnda	4
珒	jnwa
廑	jnga
琎	jnwj
墐	jnta	5
卺	jnlv
经	jysg
竟	jyle
精	jymo	5
镜	jyje
净	jydv
静	jyqv
竞	jyle
景	jyox
井	jyaa
敬	jycw
京	jywx
鲸	jyex
惊	jyxx	4
颈	jyvr
警	jyck
境	jyte
茎	jycg
荆	jycd
径	jyrg
靖	jylo
菁	jyco
晶	jyoo
睛	jymo
璟	jywx
胫	jyog
粳	jymg
阱	jyej
劲	jyvl
旌	jyfu
肼	jyoj
泾	jydg
婧	jyno
竫	jylv
迳	jyzg
儆	jyrw
腈	jyoo
憬	jyxx	5
痉	jybg
倞	jyrx
刭	jyvd
靓	jyqj
獍	jyqe
兢	jyue
鼱	jyjo	4
汫	jydj
璥	jyww
麖	jygx
猄	jyqx
䴖	jyqn
冏	jsak	5
炯	jshk
迥	jszk
窘	jsgk
扃	jshk	4
颎	jsbr
炅	jsoh
坰	jstk
泂	jsdk
䌹	jssk
就	jqwy	5
酒	jqdy
旧	jqao	4
救	jqqw
九	jqpv
久	jqpn
揪	jqfh
灸	jqjh
鸠	jqjn
啾	jqkh
玖	jqwj
韭	jqfa
纠	jqsa
舅	jqjl
究	jqgj
咎	jqwk
臼	jqpa
鹫	jqwn
厩	jqij
僦	jqry
柩	jqlj
疚	jqbj
氿	jqdj
鬏	jqih
阄	jqmg
赳	jqta
桕	jqlj
㠇	jqsy
据	jufk
剧	juud
局	juuk	4
句	jupk
举	juea
距	juzj
聚	juen
巨	juka
居	juuk
具	juab	5
拒	jufj
狙	juqq	4
俱	jurb
菊	jucm
锯	jujk
焗	juhk	5
橘	julk	5
车	juaa	5
惧	juxb
矩	juuj
钜	jujj
鞠	jucm
遽	juzn
拘	jufk
沮	judq
驹	jumk
莒	juck
掬	jufm
踞	juzk
桔	julk	4
锔	jujk
苴	jucq	4
炬	juhj
讵	juyj
咀	jukq
琚	juwk
裾	jupk
椐	julk
鞫	juck
秬	juhj
屦	juun
倨	jurk
雎	juqa
娵	juny
苣	jucj
疽	jubq
榉	julj
筥	juvk
蒟	juck
窭	jugn
醵	juyn
飓	jufb
龃	juvq	5
崌	jusk	5
柜	julj
泃	judk
砠	juuq	5
踽	juzy
犋	junb	4
岨	jusq
枸	julk
趄	jutq
澽	judn
岠	jusj
腒	juok	4
弆	juta
䴗	jumn
卷	jrdv
捐	jrfo	4
圈	jrwv
绢	jrso
涓	jrdo
娟	jrno
倦	jrrv
隽	jrrn	5
狷	jrqo
镌	jrjn
蠲	jrei
鹃	jrkn
鄄	jrxe
眷	jrdm
焆	jrho
锩	jrjv
桊	jrdl
绝	jtsb
觉	jtej	4
嚼	jtkc
决	jtdn
撅	jtfr
倔	jtri
爵	jtpc
掘	jtfi
角	jtey
厥	jtir
诀	jtyn
珏	jtwy
玦	jtwn	5
蕨	jtcr
蹶	jtzr
噘	jtkr
崛	jtsi
攫	jtfy
谲	jtyk
橛	jtlr
抉	jtfn
傕	jtra
玃	jtqy
爝	jthc
孓	jtvn
桷	jtly
觖	jten
矍	jtmy
獗	jtqr
镢	jtjr
劂	jtid
砄	jtun
㵐	jtdr	5
均	jptd
君	jpyk
军	jpgi
郡	jpye
菌	jpch
俊	jprw
钧	jpjd
峻	jpsw
骏	jpmw
浚	jpdw
珺	jpwk
畯	jptw
竣	jplw
麇	jpgh
焌	jphw
皲	jpgy
晙	jpow
莙	jpck
筠	jpvd
捃	jpfk
龟	jpev
隽	jprn
葰	jpcw
鲪	jpek
䐃	jpoh
卡	kaub
咯	kakk	4
咖	kakk
咔	kakb
喀	kakk	5
胩	kaob
开	klaa
凯	klsj
铠	kljj
恺	klxj	4
揩	klfb
楷	kllb
锎	kljk
慨	klxj
闿	klmj
锴	kljb
忾	klxq	5
垲	kltj
炌	klhj
剀	klsd
蒈	klcb
看	kjpm
砍	kjur
坎	kjtr
刊	kjgd
堪	kjtu
槛	kjlm
侃	kjrv
勘	kjul
龛	kjrb
阚	kjmw
戡	kjug
瞰	kjmw
莰	kjcr
衎	kjrd
磡	kjul
崁	kjsr
嵁	kjsu
墈	kjtl
抗	khfj
扛	khfg
康	khgl
炕	khhj
糠	khml
钪	khjj	5
慷	khxl
亢	khwj	4
伉	khrj
闶	khmj
靠	kkgf
考	kkuv
烤	kkhk
拷	kkfk
尻	kkuj
铐	kkjk
犒	kknk
栲	kklk
洘	kkdk
㸆	kkhf
可	keav
课	keyg
克	keue
科	kehu
客	kegk
氪	keqe
颗	kegr
壳	keuj
磕	keum
刻	kewd
咳	kekr
柯	kelk
嗑	kekm
珂	kewk
棵	kelg	5
渴	kedv
恪	kexk
颏	kewr
苛	keck
窠	kegg	4
轲	keik
髁	kegg
疴	kebk	4
瞌	kemm
坷	ketk
蝌	keiu
缂	kesg
锞	kejg
骒	kemg
炣	kehk
岢	kesk
溘	kedm
稞	kehg
匼	kekk
牁	kevk	5
剋	kzud
啃	kfko
肯	kfvo
垦	kfvt
恳	kfvx
裉	kfph
坑	kgtj
吭	kgkj
铿	kgjt
硁	kgug
空	ksgg
孔	kszv
控	ksfg
恐	ksgx
崆	kssg
硿	ksug
箜	ksvg
倥	ksrg
埪	kstg
口	kbaa
扣	kbfk
抠	kbfx
寇	kbgy
叩	kbke
蔻	kbcy
芤	kbck
筘	kbvk
眍	kbmx
库	kugi
哭	kukq
苦	kuck
酷	kuyk
裤	kupi
枯	kulk
窟	kugi
喾	kuek
刳	kudd
骷	kugk
绔	kusk
矻	kuuy
圐	kuwf
跨	kwzk
夸	kwdk
垮	kwtk
胯	kwok
挎	kwfk
侉	kwrk
姱	kwnk
快	kyxn
块	kytn
会	kyrv	5
筷	kyvk
哙	kykv
脍	kyov
郐	kyre
侩	kyrv	4
蒯	kycd
鲙	kyev
浍	kydv
狯	kyqv
㧟	kyfk
款	krur
宽	krgj
髋	krgj
狂	kdqw
框	kdlw
矿	kdug	5
筐	kdvw
况	kdde
哐	kdkw
匡	kdkw
旷	kdog
诓	kdyw	5
邝	kdge
诳	kdyw	4
眶	kdmw
圹	kdtg
贶	kdbe
纩	kdsg
夼	kddi
洭	kddw
亏	kvev
奎	kvdt
窥	kvgj
蝰	kvit	4
盔	kvhm
葵	kvct
夔	kvew
魁	kvgu
匮	kvkr
愧	kvxv
溃	kvdr	4
揆	kvft
馈	kvur	4
逵	kvzt
愦	kvxr
傀	kvrv
睽	kvmt
櫆	kvlu
馗	kvjm	5
骙	kvmt
聩	kver	5
跬	kvzt
煃	kvht	5
悝	kvxl
戣	kvvg
喟	kvko
喹	kvkt
蒉	kvcr
篑	kvvr
岿	kvsg
暌	kvot
困	kpwl
坤	kptu
捆	kpfl
昆	kpob
鲲	kpeb
堃	kpft
琨	kpwb
髡	kpie
鹍	kpon
焜	kphb
阃	kpml
醌	kpyb
悃	kpxl
锟	kpjb
壸	kpuy
裈	kppi
婫	kpnb
扩	kofg
阔	komk
括	kofk
廓	koge
蛞	koik
啦	lakl
拉	lafl
辣	lalu
剌	laud
蜡	laio
腊	laoo
喇	lakd
垃	latl
落	lack
邋	lazv
镴	lajv
旯	laoj
蝲	laid
瘌	labd
砬	laul
鞡	lacl
来	llan
莱	llcl
赖	llur
铼	lljl
濑	lldr
赉	lllr	4
徕	llrl
癞	llbr	5
涞	lldl
睐	llml
崃	llsl
籁	llvr
俫	llrl
梾	llll
烂	ljhs
蓝	ljcm
懒	ljxr
兰	ljes
栏	ljls
揽	ljfj
拦	ljfs
篮	ljvm
岚	ljsx
滥	ljdm
览	ljaj
澜	ljdj
榄	ljlj
阑	ljmj
镧	ljjj
缆	ljsj
婪	ljln
褴	ljpm
斓	ljwj
谰	ljyj
罱	ljsu
襕	ljpj
漤	ljdn
狼	lhqh
浪	lhdh
郎	lhde
朗	lhdo
廊	lhge
啷	lhke
琅	lhwh
烺	lhhh
螂	lhie
崀	lhsh
阆	lhmh
锒	lhjh
榔	lhle
桹	lhlh
埌	lhth
塱	lhlt
莨	lhch	4
蒗	lhch	5
稂	lhhh
筤	lhvh
㫰	lhoh
㮾	lhll
蓢	lhco
老	lkub
捞	lkfl
佬	lkrb
唠	lkkl
劳	lkcl	4
牢	lkgn
烙	lkhk
铑	lkjb
姥	lknb
涝	lkdl
醪	lkyp
酪	lkyk
落	lkck	5
痨	lkbl	4
铹	lkjl
嫪	lknp
崂	lksl
栳	lklb
荖	lkcb
络	lksk
耢	lkfl	5
了	levv
乐	lepd
勒	lecl
叻	lekl	4
仂	lerl
鳓	leel
簕	levl
饹	leuk
泐	ledl
嘞	lekl	5
类	lzmd
累	lztx
雷	lzyt
泪	lzdm
嘞	lzkl
垒	lzvt
勒	lzcl
蕾	lzct	4
镭	lzjt
肋	lzol
磊	lzuk
擂	lzft
罍	lztf
诔	lzyn
羸	lzwf
酹	lzyc
耒	lzfn
嫘	lznx
缧	lzsx
儡	lzrt
藟	lzct	5
檑	lzlt
礌	lzut
癗	lzbt
冷	lgdv
楞	lglf
愣	lgxf
棱	lglw
崚	lgsw
塄	lgtf
堎	lgtw
里	liaa
离	liwd
力	livp
李	lilz
例	lird	4
利	lihd	4
理	liwl
立	liwa
礼	lipv
粒	liml
梨	lihl
历	liil	5
锂	lijl
丽	liad
哩	likl
黎	lihu
栗	lixl
莉	licd
吏	lian
戾	lihq
藜	licu
鲤	liel
厘	liil
笠	livl
犁	lihn
璃	liwl	5
狸	liql
厉	liiw	5
隶	livn
栎	lill
骊	liml	4
荔	licl	5
沥	lidl
俪	lirl
励	liil	4
砾	liul
醴	liyd
砺	liuw	5
澧	lidd
詈	lisk
鬲	liaa
痢	libd	4
罹	lisw
疠	libw	5
莅	licl
俚	lirl
郦	lile
喱	likl
篱	livl
鳢	lied
漓	lidl
浬	lidl
轹	liil
俐	lird	5
蓠	licl
蛎	liiw	4
蠡	livi
唳	likq
呖	likl
溧	lidl
蜊	liid	5
鲡	liel
醨	liyl
嫠	liwn
凓	lidl
枥	lill	5
逦	lizl
娌	linl
粝	limw
鹂	liln
苈	licl	4
黧	lihe	3
缡	lisl
傈	lirl
坜	litl
疬	libl
跞	lizl
朸	lill	4
珕	liwl
浰	lidd
雳	liyl
猁	liqd	4
篥	livl
㰀	lilu
俩	lwrl
连	lmzi
练	lmsd
脸	lmoa
链	lmji
联	lmed
恋	lmwx
莲	lmci
帘	lmgj
炼	lmhd
镰	lmjj
敛	lmrw
怜	lmxv
廉	lmgj
涟	lmdi
濂	lmdj
殓	lmda
蠊	lmij
琏	lmwi
楝	lmlj
鲢	lmei
奁	lmdx
蔹	lmcw
裢	lmpi
潋	lmdw
梿	lmli
浰	lmdd
裣	lmpa
瑓	lmwj
量	lddl
两	ldad
亮	ldwj
梁	lddl
辆	ldil
凉	lddx
粮	ldmh	4
良	lddh
晾	ldox
靓	ldqj
俩	ldrl
谅	ldyx
粱	lddm
椋	ldlx
俍	ldrh
魉	ldgl
墚	ldtl
莨	ldch
踉	ldzh	5
辌	ldix
悢	ldxh
聊	lcee
撩	lcfx
料	lcmu
辽	lczl
廖	lcgp
撂	lcfk
寮	lcgx
疗	lcbl
蓼	lccp
瞭	lcmx
钌	lcjl
燎	lchx
了	lcvv
獠	lcqx
潦	lcdx
僚	lcrx
憭	lcxx
髎	lcgp
寥	lcgp
嘹	lckx
橑	lclx
嫽	lcnx
缭	lcsx
镣	lcjx
尥	lcau
蹽	lczx
漻	lcdp
鹩	lcan
簝	lcvx
列	lxdd
咧	lxkd
猎	lxqo
烈	lxde
裂	lxdh
劣	lxul
鬣	lxiv	5
洌	lxdd
冽	lxdd	4
埒	lxtc
躐	lxzv	4
捩	lxfq
趔	lxtd	3
峛	lxsd
脟	lxoc
䴕	lxdn
林	lnll
拎	lnfv
临	lnaa	4
磷	lnua
琳	lnwl
凛	lndx
淋	lndl
霖	lnyl
鳞	lnea
邻	lnre
麟	lnga
璘	lnwa	5
廪	lngx
赁	lnrr
蔺	lnca
吝	lnwk
檩	lnlx
懔	lnxx
膦	lnoa	4
潾	lnda
粼	lnmv	5
嶙	lnsa	5
躏	lnzl	5
啉	lnkl
遴	lnza	4
辚	lnia
箖	lnvl
瞵	lnma
翷	lnmx
另	lykl
令	lyrv	4
零	lyyv
领	lyrr
铃	lyjv
灵	lyvh
玲	lywv
岭	lysv
陵	lyew
凌	lydw	4
龄	lyvv	4
绫	lysw
翎	lyrx
聆	lyev
泠	lydv	4
澪	lydv	5
伶	lyrv	5
蛉	lyiv
菱	lycw
苓	lycv	5
姈	lynv
羚	lyev	4
呤	lykv	4
瓴	lyrw
棂	lylh
祾	lypw
鲮	lyew	5
舲	lyvv
棱	lylw
酃	lyye
坽	lytv	5
囹	lywv
柃	lylv
鸰	lyrn
昤	lyov
㥄	lyxw
六	lqwb
留	lqpt
流	lqdv
刘	lqwd
溜	lqdt
柳	lqle
硫	lquv
遛	lqzt
瘤	lqbt
镠	lqjp
琉	lqwv
熘	lqht
浏	lqdd
绺	lqsk
榴	lqlt
旒	lqfv
陆	lqej
鎏	lqdj
骝	lqmt
馏	lqut
镏	lqjt
锍	lqjv
珋	lqwe
疁	lqtp
罶	lqst
鹨	lqxn
瑬	lqdy
飗	lqft
碌	lquu
鹠	lqln
咯	lokk
龙	lsab	4
隆	lseu	5
泷	lsdb
拢	lsfb
笼	lsvb
陇	lseb
聋	lsle
珑	lswb
胧	lsob
垄	lslt
茏	lscb
栊	lslb
砻	lslk
咙	lskb
哢	lskn
癃	lsbu
窿	lsgu
昽	lsob
弄	lswa
漋	lsdu
眬	lsmb
楼	lbln
喽	lbkn
漏	lbdy
搂	lbfn
娄	lbmn
瘘	lbbn	4
露	lbyk
篓	lbvn
镂	lbjn
陋	lbeb
蒌	lbcn
耧	lbfn	5
蝼	lbin
偻	lbrn
溇	lbdn
髅	lbgn
嵝	lbsn	4
䁖	lbmn
剅	lbdd
路	luzk
录	luvu
撸	lufo
陆	luej
鲁	lueo
鹿	lugb
卢	luau	4
露	luyk
卤	luax
炉	luhh
虏	lual	4
噜	luko
麓	lulb
掳	lufl
禄	lupu
戮	luxg
庐	lugh
垆	lutu
橹	lulo
璐	luwk
芦	luch
潞	ludk
颅	lulr
泸	ludu
鹭	luzn
胪	luou
渌	ludu
镥	lujo
赂	lubk
鲈	lueu
菉	lucu
簏	luvb
蕗	luck
碌	luuu
漉	ludb
僇	lurp
栌	lulu
箓	luvu
辂	luik
舻	luvu
琭	luwu	4
辘	luib	5
逯	luzu
鸬	luln	4
甪	lupy
绿	lusu
轳	luiu	5
勠	luxl	5
澛	ludo
氇	lumo
稑	luht
乱	lrqv
卵	lrpd
鸾	lrwn
栾	lrwl
銮	lrwj
峦	lrws
娈	lrwn
挛	lrwu
脔	lrwr
孪	lrwz
滦	lrdl
论	lpyb
轮	lpib
抡	lpfb
伦	lprb
仑	lprb
纶	lpsb
沦	lpdb
囵	lpwb
罗	losx
落	lock
洛	lodk
裸	lopg
啰	lokx
骆	lomk	4
摞	lofx
螺	loix
络	losk
骡	lomx
锣	lojx
萝	locx
雒	lowa
珞	lowk	5
逻	lozx
蠃	lowf
箩	lovx
烙	lohk
泺	lodl
荦	locn
漯	lodx
捋	lofc
倮	lorg
椤	lolx
瘰	lobx
猡	loqx
蓏	locg
脶	loon
率	lvwu
绿	lvsu
铝	lvjk
吕	lvkk
驴	lvmh
旅	lvfh
律	lvra
捋	lvfc
氯	lvqu
屡	lvun
滤	lvdx
虑	lvax
履	lvuw
缕	lvsn
侣	lvrk
闾	lvmk
膂	lvfo
梠	lvlk	5
榈	lvlk	4
褛	lvpn
偻	lvrn
稆	lvhk
葎	lvcl
垏	lvta
略	lttk
掠	ltfx
锊	ltjc
圙	ltwm
䂮	ltfk
吗	makm	4
嘛	makl
骂	makm	5
马	mava
码	maum	4
妈	manm
麻	magl
玛	mawm
蚂	maim
抹	mafm
蟆	maid
祃	mapm
犸	maqm	5
摩	magu
杩	malm
买	mlvd
卖	mlud
麦	mlaw
埋	mltl
迈	mlzw
脉	mloy
霾	mlyl
唛	mlkw
劢	mlwl
荬	mlcd
鿏	mljw
慢	mjxy
满	mjdl
蛮	mjwi
曼	mjoy
漫	mjdy
螨	mjil
瞒	mjml
蔓	mjcy
幔	mjjy
鳗	mjey
缦	mjsy
馒	mjuy
谩	mjyy
鬘	mjiy
墁	mjty
嫚	mjny
镘	mjjy
颟	mjcr
鞔	mjcm
埋	mjtl
忙	mhxw
盲	mhwm
莽	mhca
芒	mhcw	4
氓	mhwm
蟒	mhim
茫	mhcw	5
邙	mhwe
漭	mhdm
尨	mhap
牻	mhnp
牤	mhnw
厖	mhip
杧	mhlw
硭	mhuw
猫	mkqt
毛	mkpv
冒	mkam
帽	mkjm
锚	mkjt
贸	mkpr
矛	mkvp
卯	mkpe
茅	mkcm	5
貌	mkpe
昴	mkoe
茂	mkcg
旄	mkfm	5
峁	mkse
髦	mkim
铆	mkje
耄	mkum	5
楙	mkll
懋	mklx
芼	mkcm	4
瑁	mkwm
牦	mknm	4
茆	mkce
袤	mkwh
瞀	mkvm
泖	mkde
眊	mkmm	3
鄚	mkce	4
蝥	mkvi	5
蟊	mkvi	4
么	mepv
没	mzdy
每	mzpm	4
美	mzed
枚	mzlw
梅	mzlm	5
酶	mzym
妹	mznw
煤	mzhl
霉	mzym
镁	mzjd
眉	mzvm
魅	mzgw
玫	mzww
媚	mznm
昧	mzow
媒	mznl
莓	mzcm
镅	mzjm
郿	mzme
寐	mzgw
湄	mzdm
浼	mzdm
袂	mzpn
楣	mzlm
鹛	mzmn
渼	mzdd
瑂	mzwm
糜	mzgm
媄	mznd
嵋	mzsm
们	mfrm
门	mfdv
焖	mfhx
闷	mfmx
扪	mffm
钔	mfjm
呇	mfuk
懑	mfdx
梦	mglx
猛	mgqm
萌	mgco
蒙	mgcn
懵	mgxm
孟	mgzm
锰	mgjm
盟	mgom
獴	mgqm	4
勐	mgzl
虻	mgiw
檬	mglm
蠓	mgim
甍	mgcw
艋	mgvm
朦	mgom	4
瞢	mgcm
幪	mgjm
艨	mgvm
蜢	mgim
礞	mgum	5
㠓	mgsm	5
鹲	mgcn
米	midl
迷	mizm
密	migs
谜	miym
蜜	migi
咪	mikm
弥	migx
觅	mipj
幂	migj
蘼	micf
芈	miaa
秘	mihb
靡	migf
眯	mimm
糜	migm
醚	miym
祕	mipb
祢	mipx
弭	mige
麋	migm
泌	midb
汨	mido
宓	migb
谧	miym
脒	miom
蓂	micb
醾	miym
縻	migx
猕	miqx
敉	mimw
洣	midm
嘧	miks
面	mmaa
免	mmev	4
棉	mmlj
眠	mmmm
缅	mmsm
绵	mmsj
勉	mmel
冕	mmam
沔	mmdv
眄	mmmv
丏	mmav
勔	mmml
愐	mmxm
娩	mmnm
湎	mmdm
腼	mmom
偭	mmrm
渑	mmdd
秒	mchu
喵	mckt
庙	mcgy
妙	mcnu
瞄	mcmt
苗	mcct
描	mcft
淼	mcuu
渺	mcdu
眇	mcmu
缈	mcsu
杪	mclu
邈	mcze
藐	mcce
缪	mcsp
鹋	mccn
灭	mxah
咩	mxky
乜	mxvv
蔑	mxcg
篾	mxvg
民	mnvv	4
敏	mnmw
皿	mnaa
抿	mnfm
闽	mnmi
泯	mndm
闵	mnmx
缗	mnso
旻	mnox
愍	mnmx
湣	mndo
珉	mnwm
悯	mnxx
岷	mnsm
鳘	mnmy
黾	mnkd	5
忞	mnwx
苠	mncm
名	myxk	5
命	myre
明	myoo
鸣	mykn
茗	myck	4
冥	mygb
铭	myjk
暝	myob
洺	mydk
溟	mydb
瞑	mymb
酩	myyk
螟	myib
谬	mqyp
缪	mqsp
莫	mocd	4
磨	mogk	5
魔	mogv
摸	mofd
膜	mood
末	moan
抹	mofm
麽	mogm
墨	moht
没	mody
摩	mogu
默	mohq
模	mold
馍	moud
沫	modm
摹	mocu	5
殁	mody
陌	moeo
茉	mocm
谟	moyd
貘	mopd
漠	modd
貊	mopo
镆	mojd	4
蘑	mock	5
秣	mohm
蓦	mocm
寞	mogd
万	moap
瘼	mobd	4
嬷	monm
耱	mofk	5
无	moav
脉	mooy
嫫	mond
靺	mocm
藦	mocu	4
某	mbgl
谋	mbyl
牟	mbvn
缪	mbsp
眸	mbmn
哞	mbkn
侔	mbrn
鍪	mbvj
蛑	mbin
木	muun	4
目	muwe
墓	muct
姆	munm
母	muvd
穆	muhp
沐	mudl
亩	muwt	4
牧	munw
暮	muco
模	muld	5
慕	mucd
幕	mucj
钼	mujm	5
募	mucl
拇	mufm
睦	mumt	4
牡	munt	5
呒	mukw
苜	mucm
牟	muvn
仫	murm
毪	mumn
那	nave
拿	naru
哪	nake
呐	nakn
娜	nane
纳	nasn
钠	najn
捺	nafx
镎	naju
衲	napn
乸	naym
南	nauu
肭	naon
乃	nlvp
奶	nlnn
耐	nlec
奈	nldx
氖	nlqn
萘	nlcx
柰	nllx
迺	nlzx
艿	nlcn
鼐	nlnd
耏	nlep
佴	nlre
难	njya
男	njtl
南	njuu
楠	njlu
喃	njku
腩	njou
囡	njwn
赧	njty
蝻	njiu
婻	njnu
萳	njcu
囊	nhah
馕	nhuh
曩	nhoh
攮	nhfh
齉	nhzh
囔	nhkh
脑	nkox
闹	nkmj
挠	nkfe
恼	nkxx
淖	nkdu
瑙	nkwx
孬	nkbz
铙	nkje
垴	nktx
呶	nkky
猱	nkql
臑	nkoe
蛲	nkie
硇	nkux
峱	nkqs
呢	nekb
讷	neyn
哪	neke
内	nzad
馁	nzun
嫩	nfnw
恁	nfrx
能	ngvb
你	nirx
尼	niub
逆	nizp
泥	nidb
拟	nifr
匿	nikk
腻	niog
妮	ninb
倪	nire
呢	nikb
溺	nidd
铌	nijb
昵	niob
霓	niye	4
睨	nime
伲	nirb
鲵	niee
猊	niqe
旎	nifb
麑	nige
坭	nitb
怩	nixb
薿	nicr
年	nmpa
念	nmrx
黏	nmhk
碾	nmuh
撵	nmfi
捻	nmfx
辇	nmfi
蔫	nmce
拈	nmfk
廿	nmaa
鲇	nmek
埝	nmtx
粘	nmmk
娘	ndnh
酿	ndyh
鸟	ncpa
尿	ncuu
茑	nccn
脲	ncou
袅	ncph
捏	nxft
镍	nxjl
涅	nxdt
聂	nxey
孽	nxcz	4
镊	nxjy
颞	nxer
蹑	nxzy
臬	nxzl
啮	nxki
蘖	nxcl
嗫	nxky
乜	nxvv
嵲	nxsl
菍	nxcx	5
糵	nxcm
陧	nxet
您	nnrx
拧	nyfd
宁	nygd
凝	nydr	4
甯	nygy	5
狞	nyqd
柠	nyld
苧	nycd
佞	nyrn
泞	nydd
咛	nykd
聍	nyed
牛	nqpa
扭	nqfi
妞	nqni
纽	nqsi
钮	nqji
拗	nqfl
狃	nqqi
杻	nqli
忸	nqxi
弄	nswa
浓	nsdh
农	nsdh
侬	nsrh
脓	nsoh
秾	nshh
哝	nskh
耨	nbfc
怒	nunx	5
努	nunl
弩	nung
奴	nuny
驽	nunm
傉	nurc
孥	nunz	4
砮	nunk
胬	nunr
笯	nuvy
暖	nroy
诺	noyk
挪	nofe
糯	nome
喏	nokk
傩	norn
懦	noxe
搦	nofd
锘	nojk
娜	none
女	nvva
钕	nvjn
衄	nvxi
恧	nvex
虐	ntaa
疟	ntba
哦	ookg
噢	ookd
喔	ookt
欧	oukr
藕	oucd
偶	ourd
呕	oukx
区	oukx
鸥	oukn
沤	oudx
殴	ouky	4
耦	oufd
讴	ouyx
瓯	oukw	5
怄	ouxx
怕	paxb
爬	pavb
趴	pazb
啪	pakb
帕	pajb
扒	pafb
耙	pafb
葩	pacb
琶	pawb
杷	palb
舥	pavb
潖	padb
筢	pavb
拍	plfb	4
派	pldh
牌	plpu
排	plff
湃	pldf
俳	plrf
徘	plrf
哌	plkh
迫	plzb	5
蒎	plch
簰	plvu
盘	pjvm
判	pjdd
潘	pjdt
畔	pjtb
攀	pjlu
盼	pjmd
叛	pjdy
爿	pjva
磐	pjvk
袢	pjpb	4
槃	pjvl
蟠	pjit
泮	pjdb
襻	pjpu	5
胖	pjob
番	pjpt
磻	pjut
蹒	pjzl
旁	phwf
胖	phob
庞	phgb
彷	phrf	4
磅	phuf
滂	phdf
乓	phqd
逄	phza
螃	phif
耪	phff
雱	phyf
鳑	phef	5
膀	phof
跑	pkzv
泡	pkdv
炮	pkhv
抛	pkfl
刨	pkbd
袍	pkpv
匏	pkdv	5
庖	pkgv
咆	pkkv
狍	pkqv	4
疱	pkbv
脬	pkoz
配	pzyj
赔	pzbk
陪	pzek
佩	pzrj
呸	pzka
胚	pzoa
裴	pzfh
培	pztk
醅	pzyk
沛	pzda
辔	pzsk
旆	pzfa
锫	pzjk
帔	pzjy
霈	pzyp
衃	pzxb
喷	pfkr
盆	pfbm
湓	pfdm
捧	pgff
碰	pguy
彭	pgup
砰	pguu
棚	pglo
硼	pguo
朋	pgoo
鹏	pgon
烹	pgwe
嘭	pgkp
蓬	pgcf
膨	pgop
篷	pgvf
澎	pgdp
芃	pgcf
抨	pgfu
椪	pgly
怦	pgxu
弸	pggo
堋	pgto
淜	pgdo
蟛	pgip
搒	pgff
皮	pivy
屁	piub	5
批	pifb
劈	piud
匹	pike
啤	piku	4
脾	piou
癖	pibu
披	pify
辟	piuu	4
铍	pijy
丕	piba
疲	piby
毗	pitb
痞	pibk
坯	pita
嚭	piuk
僻	piru
罴	pise
譬	piuk
噼	piku	5
琵	piwb
貔	pipb	5
蜱	piiu	5
圮	pitj
陂	piey
邳	pibe
郫	pibe
伾	pira
裨	pipu	5
霹	piyu	4
媲	pinb
鼙	piuu
陴	pieu	3
甓	piuw
睥	pimu
埤	pitu
淠	pida
椑	pilu
狉	piqa
澼	pidu
枇	pilb
砒	piub	4
蚍	piib	4
纰	pisb
仳	pirb
否	pibk
鲏	piey
䴙	piun
苉	pice
篇	pmvc
偏	pmrc
片	pmpv
骗	pmmc
骈	pmmk
便	pmrg
谝	pmyc
翩	pmhx
楩	pmlg
扁	pmhc
胼	pmok
蹁	pmzc
犏	pmnc
㛹	pmng
票	pcxx
飘	pcxx
漂	pcdx
嫖	pcnx
瞟	pcmx
瓢	pcxg
剽	pcxd
缥	pcsx
骠	pcmx
朴	pclb
殍	pcdz
薸	pccx	4
嘌	pckx
蔈	pccx	5
螵	pcix
撇	pxfw
瞥	pxbm
氕	pxqp
苤	pxca
拼	pnfk
品	pnkk
频	pnvr
贫	pnbr
聘	pnev
嫔	pnnb
颦	pnvu
牝	pnnb
姘	pnnk
玭	pnwb
屏	pyuk
平	pyau	5
凭	pyrj
瓶	pyew
评	pyyu
坪	pytu
萍	pycu	5
枰	pylu	4
乒	pyqp
苹	pycu	4
娉	pynv
鲆	pyeu
俜	pyrv
冯	pydm
洴	pydk
泙	pydu
玶	pywu
涄	pydv
帡	pyjk
荓	pyck
蚲	pyiu
破	pouy
颇	popr
坡	poty
泼	pody
婆	podn
迫	pozb
珀	powb
钋	pojb
魄	pobv
钷	pojk
泊	podb
粕	pomb
鄱	pofe
皤	pobt
叵	pokk
酦	poyy
陂	poey
桲	polz
朴	polb
繁	pomx
笸	povk
䥽	pojy
剖	pbld
裒	pbwh
掊	pbfk
抔	pbfb
谱	puyo
铺	pujf
普	pueo
扑	pufb
噗	pukn
朴	pulb
葡	pucf	3
蒲	pucf	5
璞	puwn
仆	purb
浦	pudf
濮	pudn
莆	pucf	4
溥	pudc	4
瀑	pudu	5
圃	puwf
蹼	puzn
曝	puou
埔	putf
镤	pujn
堡	purt
镨	pujo
菩	puck
酺	puyf
匍	pupf
蒱	pucf	2
潽	pudo
脯	puof
墣	putn
氆	pumo
穙	puhn
其	qiab
起	qitj
期	qiqo
七	qiav
气	qipv	4
器	qikk
骑	qimk	4
齐	qiwa
棋	qilb
漆	qidu
奇	qidk
弃	qiwa
旗	qifb	4
妻	qian	4
绮	qisk
欺	qiqr
岂	qisj	5
琪	qiwb	5
砌	qiud	5
启	qihk
企	qirv
契	qifd
淇	qidb
泣	qidl
琦	qiwk	5
栖	qilx	5
鳍	qieo
乞	qipy
祁	qipe	4
戚	qixg
祇	qipu	5
麒	qigb
汽	qidq
沏	qidd
柒	qidl
祈	qipj	5
祺	qipb
讫	qiyy
脐	qioq	5
崎	qisk
岐	qisy
蕲	qicj
迄	qizy
杞	qilj	4
萁	qicb	5
嘁	qikg
欹	qidr	5
锜	qijk
凄	qidn
槭	qilg
碛	qiur
畦	qitt
綦	qiqx
歧	qivy
玘	qiwj
亓	qiea	4
耆	qiuo
芑	qicj
屺	qisj	4
埼	qitk
憩	qiqx
跂	qizy
芪	qicu	5
棨	qihl	4
葺	qice	4
蹊	qizd
颀	qijr
骐	qimb	4
汔	qidy
圻	qitj
磜	qiux
萋	qicn	4
蜞	qiib
蛴	qiiq
亟	qila
愭	qixo
桤	qilj	3
俟	qird
荠	qicq	5
婍	qink
郪	qiqe	3
稽	qiho
缉	qise
洓	qidn
鲯	qieb
碶	qiud
䓫	qick
掐	qwfj
恰	qwxk
卡	qwub
髂	qwgk
洽	qwdk
袷	qwpk
拤	qwfb
葜	qwcd
前	qmed
钱	qmjg
千	qmpu
签	qmva
浅	qmdg
欠	qmer
铅	qmjk
牵	qmdn
遣	qmza
潜	qmdo
迁	qmzq
乾	qmuy
谦	qmyj
嵌	qmsr	4
钳	qmjg
黔	qmhj
茜	qmcx	5
钤	qmjj
芡	qmcr
歉	qmer
虔	qmax
芊	qmcq
倩	qmro
骞	qmgm
仟	qmrq
堑	qmit
搴	qmgu
阡	qmeq
谴	qmyq
汧	qmdk
靬	qmcg
荨	qmcc
愆	qmrx
佥	qmra
椠	qmil
扦	qmfq
褰	qmgh
犍	qmnj
缱	qmsq
慊	qmxj
悭	qmxt
钎	qmjq
杄	qmlq
鹐	qmen
蒨	qmco	4
岍	qmsk
磏	qmuj
纤	qmsq
掮	qmfo
墘	qmty
肷	qmor	5
圲	qmtq
伣	qmrj
强	qdgi
抢	qdfv
枪	qdlv
墙	qdtk
腔	qdog
呛	qdkv
羌	qdev
蔷	qdck
炝	qdhv
羟	qdeg
锵	qdjc
戗	qdrg
戕	qdvg
锖	qdjo
樯	qdlk
玱	qdwv
镪	qdji
蜣	qdiv
嫱	qdnk
襁	qdpi
跄	qdzv
蔃	qdci
敲	qcwy
桥	qclq
乔	qcya	4
翘	qcgx
瞧	qcme
巧	qcgv
撬	qcfm
壳	qcuj
鞘	qcco
俏	qcro
樵	qcle
窍	qcgq
谯	qcye
锹	qcjh
侨	qcrq
悄	qcxo
跷	qcze
荞	qccq
诮	qcyo
橇	qclm
峤	qcsq
劁	qcrd
峭	qcso
缲	qcsl
硚	qcuq	5
鞒	qccq	5
雀	qcua
憔	qcxe	5
愀	qcxh	4
硗	qcue	4
且	qxaa
切	qxqd
妾	qxln
窃	qxgd
怯	qxxv
茄	qxck
箧	qxvj
挈	qxfu
伽	qxrk
锲	qxjd
惬	qxxj
郄	qxxe
慊	qxxj
趄	qxtq
琴	qnwj
秦	qnah
亲	qnlx
勤	qncl
寝	qngy
擒	qnfl
钦	qnjr
沁	qndx
侵	qnry
禽	qnrl
衾	qnrh
噙	qnkl
芹	qncj
骎	qnmy
溱	qndh
覃	qnxu
嗪	qnkh
芩	qncj
揿	qnfr
梣	qnlj
慬	qnxa
嵚	qnsr
锓	qnjy
檎	qnll
吣	qnkx
请	qyyo
轻	qyig
清	qydo
氢	qyqg
情	qyxo
青	qyao
晴	qyoo
卿	qype
倾	qyrr
庆	qygd
黥	qyhx
磬	qyuk
顷	qybr
擎	qycu
箐	qyvo	4
氰	qyqo
罄	qyuf
蜻	qyio
鲭	qyeo
綮	qyhx
檠	qycl
亲	qylx
圊	qywo	5
勍	qywl
碃	qyuo
庼	qygr
倩	qyro
苘	qyck
穷	qsgl
琼	qswx
蛩	qsgi
邛	qsge
穹	qsgg
茕	qscu
銎	qsgj
筇	qsve
䓖	qscl
球	qqwq
求	qqad
秋	qqhh
邱	qqqe
丘	qqpa
裘	qqqh
糗	qqmq
楸	qqlh
囚	qqwr
逑	qqzq
湫	qqdh
虬	qqiv
璆	qqwp
酋	qqey
仇	qqrj
萩	qqch
遒	qqzy
鳅	qqeh
泅	qqdr
俅	qqrq
鼽	qqzj
赇	qqbq
龟	qqev
蚯	qqiq
蝤	qqiy
鹙	qqhn
訄	qqjk
犰	qqqj
巯	qqvv
鞧	qqcy
去	qutv
区	qukx	5
取	quey
曲	quaa
娶	quen
屈	quui
趣	quty
蛆	quiq
龋	quvy
驱	qumx	4
瞿	quma
祛	qupv
渠	qudl
趋	quta
躯	quux
鼩	qujk
觑	quxj
诎	quyi
麹	qumm
衢	qurd
蕖	qucl
蘧	qucn
袪	qupv
胠	quov
朐	quok
劬	qujl
阒	qumq
苣	qucj
璩	quwn
癯	quba
鸲	qujn
戌	quag
焌	quhw
蠼	quiy
氍	qumm
黢	quhw
岨	qusq
坥	qutq
灈	quda
岖	qusx
蛐	quiq
磲	quul
竘	qulk
㭕	qulv
䓛	quci
全	qrrw	4
圈	qrwv
权	qrly
劝	qryl
券	qrdd
拳	qrdu
犬	qrdd
泉	qrbu
醛	qryw	4
蜷	qriv
荃	qrcw
颧	qrcr
诠	qryw
佺	qrrw	5
铨	qrjw
鬈	qriv
痊	qrbw
绻	qrsv
筌	qrvw
畎	qrtq
悛	qrxw
辁	qriw	5
棬	qrlv
瑔	qrwu
鳈	qreu
婘	qrnv
却	qtte
缺	qtfn	4
确	qtuy
阙	qtmr
雀	qtua
瘸	qtbr	5
鹊	qtcn
榷	qtla
炔	qthn
阕	qtmt
悫	qtux
碏	qtuo
埆	qtty
群	qpyy
裙	qppk
囷	qpwh
麇	qpgh
逡	qpzw
然	rjpe
燃	rjhe
染	rjdl
冉	rjaa
髯	rjir
蚺	rjir
苒	rjcr
䎃	rjrx
让	rhyu
穰	rhhh
嚷	rhkh
瓤	rhwg
攘	rhfh
禳	rhph
壤	rhth
瀼	rhdh
儴	rhrh
蘘	rhch
绕	rkse
饶	rkue
扰	rkfy
桡	rkle
娆	rkne
荛	rkce
热	refe
惹	recx
人	rfpn
任	rfrr
认	rfyr
忍	rfrx
仁	rfre
刃	rfdd
壬	rfqa	4
韧	rfwr
饪	rfur
稔	rfhx
妊	rfnr
衽	rfpr	5
纫	rfsr
仞	rfrr
轫	rfir
讱	rfyr
纴	rfsr
葚	rfcu
荏	rfcr
仍	rgrn
扔	rgfn
日	riwa
驲	rimo
融	rsai
容	rsgk
蓉	rsck
荣	rscl
溶	rsdk
戎	rspg
绒	rssg
熔	rshk
冗	rsgj
茸	rsce
榕	rslk
镕	rsjk
嵘	rssl
狨	rsqg
瑢	rswk
蝾	rsil
肉	rbnr
揉	rbfl
柔	rbvl
鞣	rbcl
糅	rbml	4
蹂	rbzl	5
如	runk
入	rupn
乳	rupv
汝	rudn
儒	rure
辱	ruic
濡	rude
茹	ruck
铷	rujk
褥	rupc
襦	rupe
蓐	rucc
孺	ruze
洳	rudk
蠕	ruie
溽	rudc
缛	rusc
嬬	rune
嚅	ruke
薷	ruce
颥	ruyr
软	rrir
阮	rree
堧	rrtd
瓀	rrwe
媆	rrnd
瑞	rvwe
睿	rvam
锐	rvje
蕊	rvcx
芮	rvcn
汭	rvdn
蚋	rvin
蕤	rvcu
枘	rvln
润	rpdw
闰	rpmw
若	rock
弱	rogd
箬	rovk
偌	rork
爇	roce
蒻	rocd
鄀	roce
婼	ronk
撒	safw
萨	saci
仨	sars
洒	sadx
飒	salx
卅	saaa
靸	sacj
潵	sadw
挲	sadu
脎	saox
赛	slgr
塞	slgt
鳃	slex
腮	slox
噻	slkt
三	sjae
散	sjcw
伞	sjru
叁	sjvs
糁	sjmp
毵	sjvm
馓	sjuw
桑	shyl
嗓	shkl
丧	shuh
颡	shyr
搡	shfl
磉	shul
扫	skfa
骚	skmi
嫂	skny
搔	skfi
臊	skol
埽	sktj
缫	sksg
瘙	skbi
溞	skdi
色	seeb
瑟	sewb	4
涩	sedv
铯	sejb
塞	segt
啬	seuk
穑	sehk
璱	sewb	5
森	sfll
僧	sgro
啥	uakk
杀	uaxx
傻	uarw
沙	uadu	5
鲨	uady
莎	uacu
煞	uaee
纱	uasu
砂	uauu
刹	uaxd
痧	uabu
厦	uaiw
嗄	uakw
歃	uaqr
霎	uayn
铩	uajx
裟	uadh	4
唼	uakn
杉	ualp
挲	uadu
晒	ulox
筛	ulvj
色	uleb
山	ujaa	4
删	ujcd
闪	ujmr
善	ujek	4
扇	ujhx
衫	ujpp
擅	ujfd
陕	ujej
珊	ujwc
膳	ujok
杉	ujlp
煽	ujhx
膻	ujod
疝	ujbs
骟	ujmx
钐	ujjp
赡	ujbk
讪	ujys
禅	ujpd
剡	ujhd
缮	ujsk
鳝	ujek
苫	ujck
鄯	ujee
芟	ujcy
嬗	ujnd
埏	ujtv
汕	ujds	4
晱	ujoh
姗	ujnc
潸	ujdo	5
跚	ujzc
烻	ujhv
蟮	ujik
单	ujea
栅	ujlc
舢	ujvs
墡	ujtk	5
嶦	ujsk	5
上	uhaa
商	uhwk
伤	uhrl
熵	uhhk
尚	uhek
赏	uher
殇	uhdp
裳	uheh
觞	uhep
墒	uhtk	5
垧	uhtk	4
晌	uhok
绱	uhsk
少	ukap
烧	ukhe
稍	ukho
勺	ukpd
捎	ukfo
哨	ukko
邵	ukde
绍	uksk
梢	uklo
苕	ukck
韶	uklk
蛸	ukio
劭	ukdl
潲	ukdo
艄	ukvo
芍	ukcu
筲	ukvo
召	ukdk
鞘	ukco
睄	ukmo
柖	uklk
玿	ukwk
社	uept
蛇	ueib
设	ueyy
射	ueuc
舍	uerk
舌	ueqk
摄	uefy
涉	uedb
折	uefj
赦	uetw
奢	uedo
赊	uebx
佘	uerx
麝	uegc
慑	uexy
歙	uerr
畲	uert
阇	uemo
滠	uedy
厍	ueii
拾	uefk
猞	ueqk
谁	uzya
神	ufpu
深	ufdl	3
身	ufpp
申	ufaa	4
肾	ufao
沈	ufdv
甚	ufqv
审	ufgu
伸	ufru
什	ufru
砷	ufuu
慎	ufxb
婶	ufnu
渗	ufdp	4
侁	ufre
糁	ufmp
哂	ufkx
蜃	ufii
莘	ufcu
诜	ufye
瘆	ufbp
甡	ufuu
参	ufvp	5
燊	ufhl
谌	ufyu
椹	uflu	4
矧	ufuy	5
绅	ufsu
呻	ufku
屾	ufss
珅	ufwu
谂	ufyx
胂	ufou
葚	ufcu
鲹	ufep
娠	ufnh
棽	uflj	5
瞫	ufmu
生	ugpa	5
声	ugup
省	ugum
升	ugpa
胜	ugou
圣	ugyt
剩	ugqd
绳	ugsd
笙	ugvu
昇	ugou
盛	ugim
晟	ugog
牲	ugnu
甥	ugul	4
陞	uget
眚	ugum
乘	ugqn
嵊	ugsi
是	uior
时	uioc
式	uigg
使	uirl
事	uiav
师	uiaj
史	uian
诗	uiyc
市	uiwj	5
屎	uium
十	uiaa
视	uipj
室	uigt
石	uiak
试	uiyg
实	uigd
饰	uiuj
士	uiua
湿	uidy
食	uirh
氏	uipv
势	uifl	4
世	uiav
施	uify
失	uipf
始	uink
尸	uivp
识	uiyb
狮	uiqj
适	uizk
矢	uipt
嗜	uiko
谥	uiym
誓	uifk	5
拾	uifk
弑	uixg
释	uipa	5
示	uiex
恃	uixc
侍	uirc
仕	uiru
逝	uizj	5
豕	uian
轼	uiig
蚀	uiui
噬	uikw
匙	uiob
虱	uivi
拭	uifg	4
祏	uipk
铈	uijj	4
柿	uilj
奭	uian
莳	uicc
驶	uimu
似	uirr
舐	uiqu
筮	uivw
湜	uidr
栻	uilg
螫	uiti
贳	uiur	5
蓍	uico	4
炻	uihk
什	uiru
酾	uiyl
鲥	uiec
媞	uinr
鼫	uijk
鸤	uiun
嘘	uiky
鲺	uiei
殖	uidv
峙	uisc
襫	uipn	4
邿	uite
浉	uidj
埘	uitc
䏡	uiox
䴓	uian
受	ubpy
手	ubpv
收	ubvw
首	ubem
瘦	ubby
守	ubgc
兽	ubek
寿	ubac
售	ubrk
授	ubfy
熟	ubwe
绶	ubsy
艏	ubvm
狩	ubqc
书	uuvd
数	uumw
树	uulc
属	uuuy
输	uuid
术	uuld
叔	uuuy
熟	uuwe
蜀	uusi
竖	uual
鼠	uujv
疏	uuvv
舒	uury
梳	uulv
赎	uubd
束	uuan
孰	uuww
述	uuzu
署	uuso
黍	uuhu
塾	uuwt
姝	uunv
恕	uunx
淑	uudy
庶	uuge
戍	uudg
漱	uudr
殊	uudv
暑	uuoo	4
殳	uujy
薯	uuco	5
曙	uuoo	5
抒	uufy
蔬	uucu	4
枢	uulx
菽	uucy
澍	uudc
倏	uurq
墅	uult
腧	uuod
摅	uufx
纾	uusy
隃	uued
秫	uuhu
沭	uudu
婌	uuny
陎	uuev
毹	uurm
鄃	uure
刷	uwud
耍	uwen
唰	uwkd
帅	uyaj
甩	uypv
摔	uyfu
衰	uywh
率	uywu
蟀	uyiu
涮	urdd
栓	urlw
拴	urfw
闩	urma
腨	uroe
双	udyy
爽	udan
霜	udym
泷	uddb
孀	udnm
鹴	udyn
骦	udmm
漴	uddx
礵	udum
水	uvvn
谁	uvya
睡	uvmi
税	uvhe
帨	uvje
说	uvye
顺	upir
舜	uppa
瞬	upmu
吮	upke
楯	uplm
说	uoye
硕	uour
朔	uoeo
槊	uoel
烁	uohl
搠	uofo
铄	uojl
数	uomw
妁	uonu
蒴	uoco
四	siwe
死	sidb
斯	siqj
撕	sifj
丝	siss
似	sirr
寺	sitc
思	sitx
私	sihv
司	sivk
饲	siuk
嗣	sikk
巳	sivv
嘶	sikj
肆	siia
祀	sipv
驷	sime
姒	sinr
俟	sird
锶	sijx
泗	side
厮	siij
兕	siae
笥	sivk
汜	sidv
咝	siks
伺	sirk
鸶	sisn
涘	sidd
缌	sisx
耜	sifa
澌	sidj
蛳	siij
虒	sipj
飔	sifx
凘	sidj
㟃	sisk
楒	silx
送	sszd
宋	ssgl
怂	ssrx
松	sslv
颂	ssbr
诵	ssyy
菘	sscv
崧	sssv
耸	ssre
嵩	sssk
竦	sslu
淞	ssdv
讼	ssyv
娀	ssng
凇	ssdv
悚	ssxu
忪	ssxv
㧐	ssfy
搜	sbfy
艘	sbvy
嗖	sbky
馊	sbuy	4
叟	sbpy
廋	sbgy
薮	sbcw
溲	sbdy
瞍	sbmy	5
嗽	sbkr
蒐	sbcv
飕	sbfy
嗾	sbkd
擞	sbfw
锼	sbjy
螋	sbiy
苏	sucb
酥	suyh
素	suax
速	suzu
俗	surk
诉	suyi
宿	sugo
粟	suxm
溯	sudo
塑	suet
肃	suvd
稣	sueh
谡	suyw
愫	suxx
夙	sujd
甦	sugu
涑	sudu
窣	sugu
骕	sums
蔌	sucr
嗉	sukx
簌	suvr
傃	surx
鹔	susn
蹜	suzo
缩	suso
僳	surm
觫	sueu
算	srva
酸	sryw
蒜	srcx
狻	srqw
岁	svsx
随	sveo	4
虽	svki
遂	svzd
碎	svuu
隋	sveo
穗	svhx
髓	svgo
燧	svhs
尿	svuu
隧	sves	5
睢	svma
绥	svsn
祟	svix
荽	svcn
谇	svyu
眭	svmt
邃	svzn
濉	svda
旞	svfs
穟	svhs
璲	svws
襚	svps	3
孙	spzx
损	spfr
隼	spru
榫	splu
笋	spvy
飧	spxh
荪	spcx
狲	spqx
所	sopj
锁	sojr
索	soux
缩	soso
嗦	sokx
梭	solw
娑	sodn
蓑	soch
唆	sokw
琐	sowr
羧	soew
睃	somw
溹	sodx
葰	socw
唢	sokr
嗍	soko
莎	socu
挲	sodu
桫	solu
他	tary
它	tagb
她	tany
塔	tatk
塌	tatx
踏	tazo
挞	tafd
拓	tafk
铊	tajb
榻	talx
趿	tazj
沓	tauo
獭	taqr
闼	tamd
蹋	tazx
鳎	taex
溻	tadx
遢	tazx
鞳	tack
阘	tamx
褟	tapx
鿎	taud
太	tldd
台	tlvk
态	tltx
胎	tlok
抬	tlfk
泰	tlau
钛	tljt
肽	tlot
苔	tlck
汰	tldt
鲐	tlek
骀	tlmk
邰	tlve
薹	tlct
酞	tlyt
跆	tlzk
炱	tlvh
谈	tjyh
碳	tjuh
弹	tjgd
摊	tjfn
贪	tjrr
痰	tjbh
探	tjfl
谭	tjyu
叹	tjky
滩	tjdn
坛	tjtv
坦	tjtd
炭	tjsh	4
瘫	tjbn
檀	tjld
毯	tjmh	5
潭	tjdu
昙	tjov
钽	tjjd
覃	tjxu
郯	tjhe
坍	tjtd
璮	tjwd
镡	tjju
惔	tjxh
忐	tjux
菼	tjch
袒	tjpd
倓	tjrh
澹	tjdk
锬	tjjh
榃	tjlt
磹	tjuu
糖	thmk
汤	thdp
唐	thgk
躺	thuk
烫	thdh
堂	thet
趟	thtk
棠	thel
淌	thdk
塘	thtk
倘	thrk
膛	thot
蹚	thzt
帑	thnj
樘	thlt
镗	thjt
傥	thre
溏	thdk
螳	thit
镋	thje
搪	thfk
羰	theh
嘡	thkt
螗	thik
瑭	thwk
鄌	thge
耥	thfk
埫	thtk
铴	thjt
䣘	thee
套	tkdv
淘	tkdf
逃	tkzv
掏	tkff
讨	tkyc
桃	tklv
陶	tkef
韬	tkwj
涛	tkdc
弢	tkgy
饕	tkkh
绦	tksx
洮	tkdv
叨	tkkd
滔	tkdj
萄	tkcf
焘	tkue
梼	tklc
绹	tksf
啕	tkkf
慆	tkxj
鼗	tkvy
特	tenc
铽	tejg
慝	tekx
忒	texg
忑	texx
忒	tzxg
疼	tgbd
藤	tgcu
腾	tgom
滕	tgou
熥	tghy
誊	tgdk
縢	tgox
螣	tgoi
䲢	tgoy
题	tior
提	tifr
体	tirb
踢	tizw
替	tifo
剃	tied
梯	tild
缇	tisr	5
锑	tijd
蹄	tizj
剔	tiod
啼	tikj
悌	tixd
涕	tidd
惕	tixw
醍	tiyr
屉	tiuu
嚏	tikr
鹈	tien
擿	tifk
绨	tisd	4
荑	ticy
倜	tirk
裼	tipw
媞	tinr
鳀	tier
逖	tizh
趯	tita
瑅	tiwr	5
遆	tizj
䏲	tiod
䴘	tipn
天	tmad
甜	tmqg
填	tmtb
田	tmwu
舔	tmqd	5
添	tmdd	4
忝	tmtd
湉	tmdk
殄	tmdp
恬	tmxk
腆	tmob
阗	tmmb	4
掭	tmfd
瑱	tmwb
沺	tmdt
畋	tmtw
淟	tmdb	5
晪	tmob
盷	tmmd
黇	tmck
条	tcwx
跳	tczv
挑	tcfv
调	tcyk
祧	tcpv
窕	tcgv
朓	tcov
粜	tcim
蜩	tcik
佻	tcrv
眺	tcmv
苕	tcck	4
嬥	tcna
鲦	tcex
髫	tcik
迢	tczk
笤	tcvk
龆	tcvk	5
贴	txbk
铁	txju
帖	txjk
餮	txdh
萜	txck
听	tykj
挺	tyfr
停	tyrd
厅	tyid
亭	tywd	4
艇	tyvr	4
庭	tygr
汀	tydd	4
廷	tyzr	4
婷	tynd
霆	tyyr	5
烃	tyhg	4
铤	tyjr
珽	tywr
梃	tylr
渟	tydd	5
葶	tycd
蜓	tyir	5
莛	tycr
圢	tytd	5
桯	tylw
颋	tyzr
侹	tyrr
烶	tyhr	3
䗴	tyir	2
同	tsak
通	tszy
痛	tsby
铜	tsjk
桶	tsly
捅	tsfy
筒	tsvk
佟	tsrd
统	tsse
童	tsll
酮	tsyk
瞳	tsml
桐	tslk	5
彤	tsdp
砼	tsug
嗵	tsky
僮	tsrl
恸	tsxl
仝	tsrg
穜	tshl
潼	tsdl	5
烔	tshk
橦	tsll	4
垌	tstk
茼	tsck
洞	tsdk	4
峒	tssk
曈	tsol
哃	tskk
鲖	tsek
㛚	tsny
峂	tssd
头	tbdd
投	tbfy
偷	tbrd
透	tbzn
骰	tbgy
图	tuwd
土	tuua
吐	tukt
涂	tudx
兔	tued
突	tugq
屠	tuuo
徒	turr
凸	tuaa
秃	tuhj
途	tuzx
荼	tucx
钍	tujt
酴	tuyx
菟	tuct
稌	tuhx
堍	tutt
腯	tuom
梌	tulx
葖	tucq
㻬	tuwk
团	trwc
彖	trvn
湍	trde
抟	trfv
猯	trqe
疃	trtl
煓	trhe
推	tvfa
腿	tvoh
退	tvzh
忒	tvxg
颓	tvhr
褪	tvph
蜕	tvie
煺	tvhh
魋	tvga
囤	tpwt
臀	tpuo
吞	tptk
屯	tpav
豚	tpon
鲀	tpet
暾	tpow
焞	tphz
饨	tput
坉	tptt
褪	tpph
忳	tpxt
拖	tofy
托	tofq
脱	tooe
坨	totb
陀	toeb
驼	tomb
驮	tomd
拓	tofk
妥	topn
佗	torb
侂	torq
唾	toki
沱	todb
铊	tojb
橐	toal
鼍	tokd
鸵	tonb
椭	tolo	4
砣	toub
柁	tolb	5
箨	tovz
跎	tozb
酡	toyb
柝	toli
圫	totq
萚	tocz
庹	togi
哇	wakt
挖	wafy
娃	want
瓦	waad
蛙	wait
袜	wapm
洼	wadt
娲	wann
凹	waaa
佤	warw
窊	wagg
坬	watg
腽	waom
畖	watg
外	wlxb
歪	wlbv
崴	wlsg
万	wjap
玩	wjwe
完	wjge	4
晚	wjom
碗	wjuv
弯	wjwg
丸	wjpd
湾	wjdg
挽	wjfm	4
绾	wjsg
腕	wjov
纨	wjsw
烷	wjhe
剜	wjgd	5
皖	wjbe	5
菀	wjcv
宛	wjgv
顽	wjer
豌	wjdv
婉	wjnv
莞	wjce
畹	wjtv
脘	wjoe
椀	wjlv
婠	wjng
琬	wjwv
惋	wjxv
蜿	wjiv
芄	wjcw
蔓	wjcy
塆	wjtg
往	whrv
王	what
网	whax
望	whww
忘	whwx
汪	whdw
亡	whwv
旺	whow	4
妄	whwn
枉	whlw
罔	whaw
辋	whiw
尢	whav
惘	whxw
魍	whgw
尪	whaw	5
为	wzdd
位	wzrl	4
未	wzan
味	wzkw
微	wzrw
喂	wzkh
伪	wzrw	5
胃	wzto
维	wzsa
威	wzng
唯	wzka
魏	wzhv	5
尾	wzum	4
卫	wzea	4
谓	wzyo
围	wzww	4
韦	wzaa
惟	wzxa
委	wzhn
危	wzev
薇	wzcw
畏	wzth
煨	wzhh
伟	wzrw
隈	wzeh
炜	wzhw
违	wzzw
尉	wzuc
苇	wzcw
萎	wzcn	5
慰	wzux
纬	wzsw
鲔	wzeo
蔚	wzcc
圩	wzty
艉	wzvm
玮	wzww
帷	wzja
渭	wzdo	4
帏	wzjw	5
洧	wzdo	5
桅	wzlv
猥	wzqh	5
痿	wzbn
巍	wzsv	5
嵬	wzsv	4
猬	wzqo	4
薳	wzch
鳚	wzec
潍	wzdw
亹	wzwq	5
葳	wzcg	4
偎	wzrh
闱	wzmw
诿	wzyn
韪	wzow	4
娓	wznm
隗	wzev
溦	wzdw
沩	wzdw
硙	wzuj	5
崴	wzsg
煟	wzho	5
廆	wzgv	4
逶	wzzn
碨	wzuh	4
涠	wzdw	5
洈	wzdv
霨	wzyc
琟	wzwa
峗	wzsv
螱	wzui
鳂	wzeh
问	wfmk
文	wfwx
稳	wfhx
闻	wfme
纹	wfsx
温	wfdm
吻	wfkw
蚊	wfix	4
瘟	wfbm
玟	wfwx	5
雯	wfyx
汶	wfdx
炆	wfhx	5
辒	wfim
刎	wfwd
阌	wfmy
紊	wfwx
蕰	wfcm
榅	wflm
芠	wfcx
鳁	wfem
璺	wfpy
翁	wgbx
嗡	wgkx
瓮	wgbw
滃	wgdx
蓊	wgcx
蕹	wgcy
鹟	wgbn
我	wopg
喔	wokt
窝	wogn
握	woft
沃	wody
卧	wokb
涡	wodn
倭	worn
斡	wouu
龌	wovt
渥	wodt
偓	wort
蜗	woin
挝	wofc
肟	wook
幄	wojt
硪	woug
涴	wodv
莴	wocn
踒	wozn
无	wuav
五	wuaa
物	wunw
吴	wukt
吾	wuwk	5
勿	wupp
乌	wupa
舞	wupa
武	wuvg
屋	wuut
误	wuyt
悟	wuxk	5
唔	wukk
雾	wuyl
捂	wufk
伍	wurw
戊	wupg
污	wudk	4
呜	wukw
午	wupg
务	wuwl
巫	wuaa
兀	wuae
钨	wujw
坞	wutw
恶	wuyx
毋	wuva
邬	wuwe
诬	wuyw
寤	wugk	4
庑	wugw
侮	wurm
焐	wuhk
芜	wucw
旿	wuou
忤	wuxu
鹜	wuvn
梧	wulk
晤	wuok
骛	wuvm
杌	wule
迕	wuzu
鹀	wuwn
鼯	wujk
圬	wutk
妩	wunw
怃	wuxw	4
洿	wudk	5
浯	wudk	4
珷	wuwg
芴	wucw
婺	wuvn
鋈	wudj
屼	wuse
鹉	wuvn
铻	wujk
珸	wuwk
蜈	wuit
牾	wunk
郚	wuwe
仵	wuru
痦	wubk
靰	wuce
峿	wusk
系	xipx
洗	xide
戏	xiyg
西	xiaa
细	xist
吸	xikj
喜	xiuk
兮	xibv
希	xixj
席	xigj	4
膝	xiou
稀	xihj	5
锡	xijw
习	xivd
奚	xipd
息	xizx
昔	xico
硒	xiux
惜	xixo
袭	xilh
溪	xidd
悉	xipx
徙	xirr
曦	xiog
析	xilj
玺	xiey
熄	xihx	5
隙	xiex
夕	xipd
汐	xidx
蜥	xiij
熙	xike
茜	xicx
嘻	xikk
檄	xilw	5
铣	xije
晞	xioj
晰	xioj
犀	xiun
禧	xipk
嬉	xink
豨	xiaj	4
烯	xihj
釐	xiwl
隰	xiee
羲	xieg
郤	xibe
谿	xipk
郗	xixe
牺	xinx	4
歙	xirr
僖	xirk
熹	xiue
咥	xikt
禊	xipd
翕	xirx
觋	xiwj
皙	xilb
媳	xinx
枲	xivl
嶲	xisv
饩	xiuq	5
醯	xiym
憙	xiux
唏	xikj
舄	xije
浠	xidj
舾	xivx
淅	xidj
蹊	xizd	4
傒	xird
螅	xiix	3
肸	xiou
屣	xiur
觿	xiek
酅	xise
穸	xigx
屃	xiur
蓰	xicr
潟	xide
鳛	xieb
裼	xipw
鼷	xijd	5
阋	xime
绤	xisk
蟋	xiix	4
葸	xicx
樨	xiln
爔	xihg
睎	ximj
熻	xihx
粞	ximx
巇	xisg
窸	xigx	4
俙	xirj	5
菥	xicj
恓	xixx
嶍	xisb
暿	xiok
饻	xiuh
下	xwab
瞎	xwmk
夏	xwaw
侠	xwrj
虾	xwix
吓	xwkx
霞	xwyy
峡	xwsj
瑕	xwwy
狭	xwqj	4
匣	xwkj
辖	xwik
呷	xwkj
叚	xwvy
暇	xwoy
狎	xwqj
遐	xwzy
硖	xwuj	5
罅	xwfh
柙	xwlj
黠	xwhk
厦	xwiw
翈	xwjx
先	xmpe	4
线	xmsg
险	xmea
弦	xmgs
现	xmwj
县	xmqv
嫌	xmnj
仙	xmrs
咸	xmkg
显	xmoy	4
鲜	xmey
限	xmeh
闲	xmml	4
藓	xmcy
馅	xmuj	5
献	xmuq
贤	xmar
掀	xmfr
陷	xmej
衔	xmrd
见	xmav
酰	xmye
氙	xmqs
腺	xmou
娴	xmnl
羡	xmer
霰	xmyw
筅	xmve
纤	xmsq
宪	xmge	5
籼	xmms
蚬	xmij
冼	xmde	4
舷	xmvs
涎	xmdv
岘	xmsj
苋	xmcj
狝	xmqx
跣	xmze
燹	xmah
锨	xmjr
洗	xmde
祆	xmpt
暹	xmza
缐	xmsu
猃	xmqa
痫	xmbl	5
伭	xmrs
崄	xmsa
跹	xmzq
莶	xmca
挦	xmfc
孅	xmng
忺	xmxr
鹇	xmmn
禒	xmpn
㬎	xmoe	5
想	xdlx
像	xdrx
向	xdpk
项	xdgr
香	xdho
相	xdlm
象	xden
箱	xdvm
乡	xdvp
响	xdkk
降	xdea
翔	xdex
橡	xdlx
巷	xdcv
享	xdwz
湘	xddm
厢	xdim
镶	xdjh
祥	xdpy
饷	xduk
飨	xdxh	4
详	xdyy
襄	xdwh
芗	xdcx
庠	xdgy
骧	xdmh	4
缃	xdsm	5
瓖	xdwh	5
鲞	xddy
珦	xdwk
葙	xdcm
小	xcvd
笑	xcvy
肖	xceo
校	xclx
箫	xcvs	5
孝	xcuz
逍	xczo
萧	xccs
消	xcdo	4
削	xced
晓	xcoe
效	xcww
销	xcjo
枭	xcpl
筱	xcvw	4
鸮	xckn
骁	xcme
宵	xcgo
魈	xcgo
硝	xcuo
崤	xcso
枵	xclh
啸	xcks	4
绡	xcso
霄	xcyo
潇	xcds	5
蛸	xcio
嚣	xckk
虓	xcjj
翛	xcrx
猇	xcqj
淆	xcdo	5
皛	xcbb
哮	xckz	5
洨	xcdx
哓	xcke
涍	xcdz	4
滧	xcdw	3
蟏	xcis
敩	xcew	2
写	xxgy
些	xxve
鞋	xxct
血	xxpm
谢	xxyc
斜	xxru
蟹	xxei
邪	xxye
携	xxfn
卸	xxwe
歇	xxor
屑	xxuo
挟	xxfj
协	xxub
泻	xxdy	5
泄	xxdu
蝎	xxiv
械	xxlg
偕	xxrb
燮	xxhy
谐	xxyb
胁	xxob
解	xxen	4
榭	xxlc
楔	xxld
薤	xxcj
澥	xxdn
亵	xxwh
缬	xxsr
懈	xxxn
绁	xxsu
撷	xxfr
絜	xxfx
廨	xxgn	5
獬	xxqn
渫	xxdl
勰	xxlx
偰	xxrd
瀣	xxdj	4
颉	xxur
邂	xxzn
揳	xxfd
叶	xxku
薢	xxcn
躞	xxzy
榍	xxlo
㙦	xxrt
新	xnlj
心	xndd
信	xnrk
芯	xncx
锌	xnju	4
辛	xnlu
薪	xncj
欣	xnjr
鑫	xnrj
馨	xnuo
昕	xnoj
忻	xnxj
歆	xnlr	4
衅	xnxb
炘	xnhj
镡	xnju	5
囟	xnpx
伈	xnrx
莘	xncu
䜣	xnyj
型	xykt
性	xyxu	4
星	xyou
行	xyrd
形	xykp
姓	xynu
醒	xyyu
兴	xyeb
邢	xyke
刑	xykd
幸	xytu
杏	xylk
腥	xyou
陉	xyeg
擤	xyfb
荇	xycd
省	xyum
饧	xyup
猩	xyqu
煋	xyhu
骍	xymu
婞	xynu
惺	xyxu	5
荥	xycu
铏	xyjd
悻	xyxu
钘	xyjk
瑆	xywu
硎	xyud
胸	xsox
熊	xsve
凶	xsxa
兄	xske
雄	xsaa
匈	xspx
芎	xscg
夐	xsew
讻	xsyx
汹	xsdx
诇	xsyk
修	xqrp	5
秀	xqhn
休	xqrl	4
绣	xqsn
嗅	xqkq
溴	xqdq
锈	xqjn
羞	xqei
袖	xqpy
咻	xqkl
脩	xqro
岫	xqsy
朽	xqlv
髹	xqil
宿	xqgo
琇	xqwn	5
貅	xqpl
庥	xqgl
滫	xqdo
臭	xqzq
珛	xqwo	4
馐	xqui
鸺	xqrn
䗛	xqio
需	xuye
虚	xuay
徐	xurx
须	xupr
许	xuyu	4
续	xusd
序	xugy
嘘	xuky
叙	xury
恤	xuxx
蓄	xuct
旭	xujo
戌	xuag
绪	xuso
絮	xunx
墟	xuty
胥	xuvo
圩	xuty
栩	xulx
诩	xuyx
吁	xuky
婿	xuno
昫	xuok
煦	xuoe
媭	xupn
勖	xuml
蓿	xuco
盱	xumy
酗	xuyx
顼	xuwr
糈	xumo
溆	xudy
欻	xuhr
洫	xudx
湑	xudo
畜	xuwt
醑	xuyo
浒	xudu
旴	xuoy	5
垿	xuty
魆	xugg
谞	xuyo
珝	xuwx
㳚	xudg
冔	xuay	4
选	xrze
癣	xrby
悬	xrqx
炫	xrhs
玄	xrws	4
宣	xrgd
旋	xrfr
轩	xrig
萱	xrcd
璇	xrwr
泫	xrds
渲	xrdd
喧	xrkd	4
玹	xrws	4
烜	xrhd	4
铉	xrjs	5
漩	xrdr
暄	xrod	4
瑄	xrwd
谖	xryy
绚	xrso
楦	xrld
券	xrdd
煊	xrhd	5
衒	xrrd
眩	xrms
咺	xrkd	5
儇	xrrh
禤	xrpx
晅	xrod	5
翾	xrsx
碹	xrud
昡	xros
琄	xrwo
痃	xrbs
暶	xror
愃	xrxd
学	xtez
血	xtpm
雪	xtya
薛	xtcu
靴	xtcb
穴	xtgb
削	xted
谑	xtyn
噱	xtkn
鳕	xtex
踅	xtfr
茓	xtcb
峃	xtes
寻	xpvc
熏	xppe	4
训	xpyi	5
逊	xpzx
巡	xpzv
勋	xpkl
埙	xptr	5
巽	xpvb
讯	xpyu
循	xprm
荀	xpco
旬	xppo	4
殉	xpdo	4
薰	xpce	5
询	xpyo	4
迅	xpzu
洵	xpdo
徇	xpro
驯	xpmi	5
蕈	xpcu
浔	xpdc
郇	xpxe
鲟	xpec
荨	xpcc
恂	xpxo
醺	xpye
栒	xplo
曛	xpoe
獯	xpqe
汛	xpdu
珣	xpwo	3
噀	xpkb
峋	xpso
浚	xpdw
呀	yaky
压	yaid
牙	yaap
鸭	yajn
亚	yaay
雅	yaya	5
押	yafj
丫	yaea
芽	yacy
吖	yaky
娅	yany
哑	yaky
崖	yast
涯	yadt
氩	yaqy
鸦	yayn
伢	yary
衙	yard
轧	yaiv
蚜	yaiy
垭	yaty
猰	yaqd
玡	yawy
琊	yawe
砑	yauy
桠	yaly
迓	yazy	4
讶	yayy
揠	yafn
睚	yamt
岈	yasy
堐	yatt
盐	yjtm
眼	yjmh
演	yjdb
烟	yjhd
言	yjwk
沿	yjdk
研	yjuk
焉	yjve
严	yjai
颜	yjwr
腌	yjod	5
岩	yjsk	4
宴	yjgn
燕	yjce
验	yjma
炎	yjhh	4
咽	yjkd
延	yjzv
彦	yjwp
阎	yjmj	5
厌	yjiq
艳	yjfb
掩	yjfd
闫	yjms
焰	yjhj
淹	yjdd
晏	yjon
俨	yjri
雁	yjia
鄢	yjve
妍	yjnk
嫣	yjne	5
阏	yjmd
檐	yjlk
偃	yjrn
焱	yjhh	5
衍	yjrd
阉	yjmd
砚	yjuj
魇	yjiv
甗	yjaw	5
兖	yjwe	4
谳	yjyq
筵	yjvv
罨	yjsd
赝	yjir
弇	yjra
湮	yjdt
酽	yjyi
奄	yjdd
琰	yjwh
堰	yjtn
餍	yjih
郾	yjke
滟	yjdb
沇	yjde
芫	yjce
铅	yjjk
谚	yjyp
黡	yjie
嬿	yjne	4
唁	yjkk
胭	yjod	5
蜒	yjiv
渰	yjda
墕	yjte
棪	yjlh
戭	yjgg
掞	yjfh
蝘	yjin
殷	yjpy	4
鼹	yjjn
崦	yjsd	4
厣	yjij
恹	yjxq
漹	yjde
虤	yjhj
扊	yjhh
䶮	yjlt
觃	yjjz
杨	yhlp
养	yhea
羊	yhea
样	yhly
氧	yhqy
阳	yheo
痒	yhby
洋	yhdy
扬	yhfp
央	yhan
仰	yhre
漾	yhdy
鞅	yhcy
旸	yhop	4
秧	yhhy
佯	yhry
烊	yhhy	4
殃	yhdy
飏	yhfp	5
炀	yhhp
钖	yhjp
羕	yhey
疡	yhbp
鸯	yhyn
恙	yhex
垟	yhty
蛘	yhiy	5
泱	yhdy
怏	yhxy
玚	yhwp
徉	yhry
咉	yhky
要	ykxn	4
药	ykcu
腰	ykon	5
妖	ykny
咬	ykkx
邀	ykzw
摇	ykff
尧	ykge
姚	yknv
舀	ykpj
约	yksu
幺	ykvv
曜	ykoa
瑶	ykwf
谣	ykyf
窑	ykgf
遥	ykzf
垚	yktt
爻	ykxx
夭	ykpd
耀	ykea
吆	ykks
杳	yklo
窈	ykgl
峣	ykse
肴	ykxo
徭	ykrf	4
钥	ykjo
鳐	ykef	5
窅	ykgm
鹞	ykpn
铫	ykjv
珧	ykwv
轺	ykik
疟	ykba
靿	ykcl
侥	ykre
崾	yksn	3
猺	ykqf
媱	yknf
㙘	yktn
也	yevv
页	year
叶	yeku
野	yely
夜	yewn
业	yeaa
耶	yeee
液	yedy
爷	yebe
噎	yekd
邺	yeye
掖	yefy
谒	yeyv
椰	yele
曳	yeap
冶	yedk
晔	yeou
烨	yehu
铘	yeje
腋	yeoy
靥	yeim
倻	yere
咽	yekd
馌	yeum
揶	yefe
以	yivr
一	yiaa
亿	yiry
已	yivv
亦	yiwd
易	yiow
矣	yivd
乙	yivv
译	yiya
意	yilx	4
仪	yiry
依	yirh	5
咦	yiky
伊	yiry	4
椅	yilk
衣	yiwh
医	yikd
义	yidx	4
翼	yixb	5
宜	yigq
异	yiva
裔	yiwk
益	yiem	4
邑	yikb
移	yihx
壹	yiud	4
役	yiry
奕	yiwd
夷	yian
艺	yicy
疑	yibr	5
倚	yirk
逸	yizt
姨	yiny
忆	yixy
遗	yizr	4
议	yiyy
蚁	yiiy
噫	yikx
抑	yife
怡	yixk
乂	yipn
铱	yijh
溢	yidm	5
驿	yima
疫	yiby
翊	yilx
埸	yitw
胰	yioy	4
刈	yixd
颐	yikr
毅	yily
钇	yijy	4
懿	yiux
诣	yiyo
彝	yiva
揖	yife
弋	yiad
翳	yikx
轶	yiiu
羿	yixa	4
祎	yipw
猗	yiqk
尾	yium
镒	yijm	5
贻	yibk
佚	yiru
燚	yihh
谊	yiyq
弈	yiwa	5
诒	yiyk
咿	yiky
扆	yihh
镱	yijx	4
佾	yiro
浥	yidb
臆	yiox
瘗	yibt
缢	yism
沂	yidj	5
殪	yidd	5
峄	yisa
圯	yitv
绎	yisa
熠	yihb	5
迤	yizy
劓	yizd
翌	yixl
漪	yidk
苡	yicr
饴	yiuk	5
嶷	yisr	4
匜	yiky
屹	yisy
肄	yiba	5
挹	yifb
裛	yiwh
潩	yidb
舣	yivy	5
怿	yixa
踦	yizk
螠	yiim
嗌	yikm	5
簃	yivx
薏	yicx
黟	yihx
洢	yidy	4
繄	yikx
荑	yicy	4
旖	yifk	5
佁	yirk
悒	yixb
嫕	yinx
鹢	yien
勚	yiul
呓	yiky	4
眙	yimk	4
蜴	yiiw
酏	yiyy
鹝	yian
艾	yicx	5
廙	yigb	5
枍	yilx
癔	yibx
痍	yiby
杙	yilg
宧	yiga
椸	yily
扅	yihx
㑊	yiry
因	ynwd
音	ynlo
银	ynjh
印	ynpe
引	ynga
阴	yneo
饮	ynur
隐	ynex
瘾	ynbx	4
殷	ynpy
尹	ynvp
吟	ynkj
寅	yngb
荫	ynco
淫	yndr
胤	ynpv
龈	ynvh
铟	ynjd
洇	yndd
蚓	yniy
茵	yncd
鄞	ynce	5
堙	yntt
愔	ynxo
骃	ynmd
喑	ynko
垠	ynth
窨	yngo
氤	ynqd
禋	ynpt
嚚	ynkk
霪	ynyr
姻	ynnd
訚	ynmk
龂	ynvj	4
崟	ynsj
慭	ynlx	5
夤	ynxb
溵	yndy
茚	ynce
狺	ynqk
蟫	yniu
吲	ynky
硍	ynuh
珢	ynwh
歅	ynxr
䲟	ynee
应	yyga
硬	yyug
赢	yywf	4
英	yycy
营	yyck
樱	yyln
影	yyop
鹰	yygn
迎	yyze
盈	yynm
嬴	yywf	5
郢	yyke
嘤	yykn
瑛	yywy
蝇	yyid
颖	yybr	5
映	yyoy
莺	yycn
萤	yyci	4
婴	yybn
瀛	yydf	5
莹	yycy	5
颍	yybr	4
媵	yyon
鹦	yybn
膺	yygo
瘿	yybn
缨	yysn
楹	yylm
荧	yych	5
萦	yycx	4
罂	yybf
撄	yyfn
锳	yyjy
滢	yydy	4
荥	yycu
溁	yydl
潆	yydx	3
蓥	yycj
璎	yywn
茔	yyct
媖	yyny
䓨	yycf
哟	yoku
唷	yoko
育	yowo
用	yspa
勇	ysvl
永	ysdn
咏	ysky
拥	ysfy
涌	ysdy	5
庸	ysga	4
蛹	ysiy	4
雍	yswa
颙	ysar
俑	ysry	5
佣	ysry	4
慵	ysxy
泳	ysdy
踊	yszy
壅	yswt
痈	ysby
甬	ysvy	4
鳙	ysey	5
饔	yswh
邕	ysvb
镛	ysjy
鄘	ysge	5
澭	ysdy
臃	ysoy
墉	ysty	4
喁	yskd
恿	ysvx
埇	ysty	5
栐	ysly
㶲	yshy	5
鲬	ysey	4
有	ybao
又	ybvn
由	ybaa
油	ybdy
右	ybak
游	ybdz	5
哟	ybku
呦	ybkl
优	ybry
友	ybay
尤	ybav
铀	ybjy
鼬	ybjy
犹	ybqy
佑	ybrk
祐	ybpk
忧	ybxy
幽	ybss
釉	ybpy
幼	ybsl
邮	ybye
酉	ybaa	4
疣	ybby
诱	ybyn
悠	ybrx	5
柚	ybly
宥	ybgo
鱿	ybey
攸	ybrw	4
繇	ybpx
囿	ybwo
卣	ybaa
侑	ybro
铕	ybjo
猷	ybeq
牖	ybpf
莠	ybcn
蚴	ybil
麀	ybgb
羑	ybej
鲉	ybey
莜	ybcw
黝	ybhl
莸	ybcy
耰	ybfw
槱	yble
蝤	ybiy
浟	ybdw	4
蝣	ybiz
蚰	ybiy
与	yuaa
于	yuav
鱼	yuea	4
宇	yugy
於	yufd	5
欲	yubr
语	yuyk
雨	yuad	4
余	yurx
预	yuvr	5
玉	yuwd
羽	yuxx
域	yutg
瑜	yuwd
遇	yuzd
御	yure
禹	yupd	5
逾	yuzd
愈	yurx	5
俞	yurd
虞	yuat
渔	yudy	4
予	yuvv
豫	yuvx	4
愚	yuax
驭	yumy
喻	yukd
渝	yudd
裕	yupk
育	yuwo	4
郁	yuye
狱	yuqq
瘀	yubd
浴	yudk
舆	yupb
彧	yuag
娱	yunt
鹬	yuvn	5
芋	yucy
峪	yusk
誉	yuek
隅	yued	3
昱	yuol
欤	yuyr
谕	yuyd
榆	yuld	4
寓	yugd	5
淤	yudd	5
鬻	yuga
煜	yuhl
毓	yumv
阈	yumg
圉	yuwu
聿	yuva	5
吁	yuky
瑀	yuwy
鄅	yuye
庾	yugy
愉	yuxd
盂	yuym
钰	yujy
迂	yuzy
屿	yusy
禺	yuad
竽	yuvy
遹	yuzk
淯	yudo
妤	yuny
窳	yugg
纡	yusy
妪	yunx
鹆	yubn
俣	yurt
喁	yukd
棫	yulg
燠	yuhd
雩	yuyk
腴	yuoy
舁	yuja
玙	yuwy
谀	yuyy
矞	yuvk
敔	yuww
饫	yuuy
畬	yurt
熨	yuuh
潏	yudk
堉	yuto
嵛	yusd
蜮	yuig
圄	yuwk
艅	yuvx	4
揄	yufd
萸	yucy
邘	yuye
臾	yupn
褕	yupd
燏	yuhk
窬	yugd	5
髃	yugd
瘐	yuby
觎	yurj
龉	yuvk
嵎	yusd
尉	yuuc
蔚	yucc
狳	yuqx
滪	yudr	3
伛	yurx
蝓	yuid
蓣	yucr	4
悆	yurx	4
㺄	yuqd
元	yree
原	yrix
远	yrze
源	yrdx
愿	yrix
圆	yrwr
院	yree
员	yrkr
园	yrwe
袁	yrth
猿	yrqh
缘	yrsn
怨	yrxx
冤	yrgt
苑	yrcv
渊	yrda	5
援	yrfy
爰	yrpy
垣	yrtd
鸢	yrgn
螈	yrix
鼋	yred
沅	yrde	4
妧	yrne
媛	yrny
掾	yrfn
塬	yrtx	5
瑗	yrwy
鸳	yrxn
嫄	yrnx
辕	yrih
芫	yrce
涴	yrdv
垸	yrte
橼	yrly
蜎	yrio
眢	yrxm
圜	yrwh
湲	yrdy
箢	yrvv
羱	yrex	4
月	ytpe
越	yttg
约	ytsu
曰	ytwa
粤	ytpv
岳	ytqs
乐	ytpd
悦	ytxe
阅	ytme
跃	ytzy
钺	ytjg
玥	ytwo
樾	ytlg
刖	ytod
籥	ytvc
龠	ytrc
瀹	ytdc
哕	ytkx
栎	ytll
爚	ythc
钥	ytjo
彟	ytxy
云	ypev
运	ypzv
晕	ypoi
韵	ypld
孕	ypnz
匀	yppd
允	ypve
熨	ypuh
芸	ypcv
陨	yper
愠	ypxm
筠	ypvd
蕴	ypcm
殒	ypdr
昀	ypod
妘	ypnv
赟	ypwr
狁	ypqe
韫	ypwm
恽	ypxi
氲	ypqm
缊	ypsm
郓	ypge
耘	ypfv
郧	ypke
酝	ypyv
筼	ypvr
煴	yphm
沄	ypdv
纭	ypsv
鋆	yptj
涢	ypdr
员	ypkr
馧	yphm
咋	zakv
砸	zauj
杂	zajx
咂	zakj
匝	zakj
扎	zafv
拶	zafx
臜	zaor
在	zlat
再	zlar
载	zlig
哉	zlkg
崽	zlsx
宰	zlgu
仔	zlrz
栽	zllg
灾	zlgh
甾	zlvt
赞	zjxr
咱	zjkz
攒	zjfr
暂	zjio
簪	zjvo
錾	zjij
瓒	zjwr
拶	zjfx
昝	zjwo
酂	zjxe
趱	zjtr	5
糌	zjmo	4
寁	zjgr
脏	zhot
葬	zhca
臧	zhig
藏	zhcg
牂	zhvy
赃	zhbt
奘	zhvd
驵	zhmq
早	zkou
造	zkzk
遭	zkzo
灶	zkht
糟	zkmo
枣	zkad
凿	zkya
澡	zkdl
皂	zkbq
燥	zkhl
躁	zkzl
藻	zkcl
噪	zkkl
蚤	zkii
璪	zkwl
慥	zkxk
簉	zkvk
唣	zkkq
则	zebd
啧	zekr
泽	zeda
择	zefa
责	zear
仄	zeir
帻	zejr	5
昃	zeor
咋	zekv
迮	zezv
笮	zevv
箦	zevr	4
赜	zekr
舴	zevv
贼	zzbg
鲗	zzed
怎	zfvx
谮	zfyo
增	zgto
赠	zgbo	4
甑	zgew
缯	zgso
曾	zgeo	5
憎	zgxo	4
鄫	zgee
罾	zgso
矰	zguo	5
锃	zgjw
综	zgsx
䎖	zgex
炸	vahv	4
渣	vadd
扎	vafv
榨	valv	5
乍	vapa
札	valv
闸	vamj
诈	vayv
眨	vamf
吒	vakq	5
栅	valc
咤	vakq	4
铡	vajd
轧	vaiv
揸	vafd
鲊	vaev
砟	vauv
楂	vald	4
劄	vavd
喳	vakd
霅	vayk
拃	vafv
咋	vakv
溠	vadg
哳	vakj
奓	vadx	4
蚱	vaiv	5
查	vald	5
馇	vaud
挓	vafq
柞	valv	4
喋	vakl
痄	vabv
䃎	vaux	5
鲝	vaey
齇	vazq
债	vlrr
窄	vlgv
宅	vlgq
摘	vlfk
寨	vlgx
斋	vlwe
翟	vlxa
祭	vlpx
择	vlfa
瘵	vlbx
豸	vlpp
站	vjlk
占	vjak
战	vjvg
斩	vjij	5
粘	vjmk
沾	vjdk
展	vjuh
詹	vjek
蘸	vjce
栈	vjlg
盏	vjgm
毡	vjmk
瞻	vjmk
旃	vjfd
绽	vjsr
湛	vjdu
辗	vjih	4
鳣	vjed
鹯	vjwn
飐	vjfk
崭	vjsj
栴	vjld
谵	vjyk
偡	vjru
搌	vjfh
张	vhgi
章	vhlu
涨	vhdi
长	vhpn
帐	vhji
账	vhbi
仗	vhrv
掌	vheu
杖	vhlv
胀	vhoi
丈	vhan
彰	vhlp
障	vheu
璋	vhwu
蟑	vhiu
鄣	vhle
瘴	vhbu
漳	vhdu
嶂	vhsu
獐	vhqu
樟	vhlu
幛	vhju
仉	vhrj
嫜	vhnu
暲	vhou
找	vkfg
招	vkfk
赵	vktx
照	vkoe
兆	vked
罩	vksu
诏	vkyk
昭	vkok
召	vkdk
朝	vkuo
着	vkem
棹	vklu
肇	vkha
钊	vkjd
沼	vkdk
曌	vkog
爪	vkpn
旐	vkfv
笊	vkvv
啁	vkkk
这	vezx
者	veuo
着	veem
折	vefj
浙	vedj
遮	veze
哲	vefk
辄	veiv
锗	vejo
褶	vepb
蛰	vefi	5
辙	veiw
啫	veko
柘	velk
谪	veyk
蜇	vefi	4
喆	veuk
磔	veul
赭	veto
蔗	vece
晢	vefo
詟	velk
鹧	vegn
䗪	vegi
真	vfub
朕	vfod
镇	vfjb
帧	vfjr
针	vfju
阵	vfei
枕	vflv
震	vfyh
臻	vfvh
珍	vfwp
甄	vfxw
振	vffh
贞	vfar
箴	vfvg
诊	vfyp
缜	vfsb
斟	vfuu
侦	vfrr
鸩	vfdn
砧	vfuk
赈	vfbh
祯	vfpr
轸	vfip
榛	vflh
疹	vfbp
桢	vflr
胗	vfop
圳	vfti
畛	vftp
稹	vfhb
禛	vfpb
鬒	vfib
瑧	vfwh
葴	vfcg
蓁	vfch
揕	vffu
袗	vfpp
浈	vfdr
昣	vfop
纼	vfsy
正	vgav
证	vgyv
挣	vgfv
蒸	vgce
整	vguv
症	vgbv
争	vgev
郑	vgee
征	vgrv
政	vgvw
睁	vgmv
筝	vgvv
怔	vgxv
烝	vgle
钲	vgjv
铮	vgjv
狰	vgqv
拯	vgfi
峥	vgsv
诤	vgyv
只	vikb
之	vidn
至	viat
值	virv
指	vifo	4
纸	visu
制	vipd
治	vidk
直	viua
知	viuk
支	viuy
致	vivw	5
质	vipr
汁	vidu
志	viux
置	visv
智	viuo
止	viua
酯	viyo
职	vieb
执	vifw	5
掷	vife
枝	vily
痣	vibx
脂	vioo	5
趾	vizv
彘	vivb
织	visb
吱	viky
芝	vicv
植	vilv
滞	vidj
跖	vizk
炙	viph	4
秩	vihu
旨	vibo	4
侄	virt
徵	virw
祗	vipd
栀	vilv	5
芷	vicv
址	vitv
雉	viua
窒	vigt	5
肢	vioy	5
陟	vieb
痔	vibc
沚	vidv
枳	vilb	5
栉	vile	4
稚	viha
卮	vipv
挚	vifu
郅	vive
轵	viib	4
殖	vidv	5
畤	vitc
峙	visc
絷	vifx	4
帙	viju	5
摭	vife
蛭	viit
鸷	vifn
铚	vijt
蜘	viik
踬	vizr
祉	vipv
埴	vitv	4
帜	vijb	4
豸	vipp
扺	vifu
贽	vifr	5
锧	vijr
骘	viem
踯	vize
咫	viib
觯	vied
桎	vilt	4
滍	vidi
泜	vidd
黹	viyd
轾	viit
跱	vizc
忮	vixy
氏	vipv
稙	vihv
疐	viur
识	viyb
禔	vipr
胝	viod
晊	viot
庤	vigc
梽	vilx	4
榰	vilo	5
中	vsaa
种	vshv
重	vspa
众	vsrr
钟	vsjv
终	vssd
忠	vsvx
肿	vsov
冢	vsgn
仲	vsrv
盅	vsvm
锺	vsjv
柊	vsld
踵	vszv
衷	vswh
舯	vsvv
螽	vswi
茽	vscv
周	vbpk
轴	vbiy
州	vbda
粥	vbgg
咒	vbkj
肘	vboc
洲	vbdv
舟	vbpd
皱	vbey
昼	vbid
纣	vbsc
胄	vbyo
骤	vbmj
宙	vbgy
籀	vbvt
酎	vbyc
诌	vbya
绉	vbsa
帚	vbvj
辀	vbiv
啁	vbkk
鸼	vbvn
赒	vbbk
碡	vbum
婤	vbnk	4
妯	vbny	5
荮	vbcc
㑇	vbra
㤘	vbxa
主	vuwt
住	vurv
注	vudv
煮	vuue
猪	vuqo
祝	vupe
著	vuco
朱	vupw
柱	vulv
诸	vuyo
助	vuql
驻	vumv
竹	vupd
诛	vuyv
渚	vudo	5
珠	vuwv
株	vulv
铸	vujc
逐	vuzn
筑	vuvf
蛛	vuiv
箸	vuvo
邾	vuve
铢	vujv
烛	vuhi	4
蛀	vuiv	5
贮	vuba
嘱	vuky
拄	vufv
炷	vuhv	4
洙	vudv
茱	vucv
伫	vura
竺	vuve
纻	vusa
瞩	vumy
苎	vuca
麈	vugv
槠	vulo
舳	vuvy
疰	vubv
杼	vuly	4
潴	vudo	4
侏	vurv
翥	vuux
砫	vuuv
柷	vule
躅	vuzi
蠋	vuii	5
橥	vuql
术	vuld	5
瘃	vubn
抓	vwfv
爪	vwpn
髽	vwit
拽	vyfy
转	vriv
赚	vrbj
专	vrad	5
砖	vruv	4
撰	vrfb
传	vrrv
篆	vrvn
馔	vrub
颛	vrsr
僎	vrrb
啭	vrkv
瑑	vrwn
沌	vrdt
䏝	vrov
装	vddh
状	vddq	4
撞	vdfl
庄	vdgt
妆	vddn
桩	vdlt
壮	vddu
幢	vdjl
戆	vdlx
奘	vdvd	5
追	vvza
坠	vvet
锥	vvja
缀	vvsy
椎	vvla
隹	vvra
骓	vvma
赘	vvar
缒	vvsv
惴	vvxe
准	vpda
肫	vpot
屯	vpav
谆	vpyz
窀	vpgt
衠	vprd
桌	voal
捉	vofr
啄	vokn
卓	voau
浊	vodi
灼	vohu
着	voem
拙	vofi
斫	vouj
酌	voyu
叕	voyy
擢	vofa
濯	voda
焯	vohu
镯	voji
琢	vown
涿	vodn	5
汋	vodu	4
倬	voru
茁	voci
浞	vodr
椓	voln
禚	vope
诼	voyn
棁	vole
晫	voou
䓬	vocu
䦃	vojo
字	zigz	5
自	zipm
子	ziva	4
紫	zivx
兹	zies	5
资	zidr
仔	zirz
籽	zimz
姿	zidn
滋	zids
渍	zidr
梓	zilu
嗞	ziks
姊	zinp
咨	zidk
恣	zidx	4
赀	zivr
訾	zivk
髭	ziib
笫	zivp
粢	zidm
吱	ziky
缁	zist
孖	zizz	4
眦	zimb
孳	ziez	3
觜	zivy
龇	zivb	5
孜	zizw	5
滓	zidu
辎	ziit
淄	zidt
秭	zihp
茈	zicb	4
镃	zijs
耔	zifz
嵫	ziss
鼒	zicd
虸	ziiz
锱	zijt
趑	zitr
鲻	ziet
鄑	ziye
总	zsex
宗	zsgx
纵	zssr
棕	zslx
综	zssx
粽	zsmx	5
踪	zszx	4
鬃	zsix	3
腙	zsox
疭	zsbr
倧	zsrx
枞	zslr
鬷	zsaw
偬	zsrx
走	zbtr
揍	zbft
奏	zbat
邹	zbee
陬	zbey
诹	zbyy
驺	zbma
鲰	zbey
鄹	zbee
组	zusq
族	zufd
足	zukr
租	zuhq
卒	zuwu
祖	zupq
阻	zueq
俎	zurq
菹	zucq
镞	zujd
诅	zuyq
崒	zusu
珇	zuwq
钻	zrjk
攥	zrfx
纂	zrvx
缵	zrsr
躜	zrzr
最	zvoy
嘴	zvky
罪	zvsf
醉	zvyu
蕞	zvcy
槜	zvln
咀	zvkq
尊	zpec
遵	zpzc
樽	zplc
鳟	zpec
噂	zpkc
撙	zpfc
僔	zprc
嶟	zpsc
做	zorw
作	zorv
坐	zort
左	zoag
座	zogt
佐	zorg
嘬	zoky
昨	zoov
撮	zofy
唑	zokt
酢	zoyv
祚	zopv
琢	zown
怍	zoxv
阼	zoev
胙	zoov	4
捽	zofu
柞	zolv
笮	zovv
岞	zosv	5
孖	mazz
